wid.1	wid.2	amino_acid.1	amino_acid.2
CAAATACCAGACGGAGGAGGAGGAGGT	CAAATACCAGAC---GGAGGAGCTGGA	QIPDGGGGG	QIPD-GGAG
TGCTACGTGGGTGGGCTTAGAGCCATGAGGAGCACA	TACCTGTGTGGA------------CGCCACACGGAC	CYVGGLRAMRST	YLCG----RHTD
TCCCAGCAGCAGGGTGGCGGCGGCGGCGGG	GCCCAGCACCAG------GGTGGCAGTGGC	SQQQGGGGGG	AQHQ--GGSG
AGCTGTGTCGCCTGTGAAGACAGAGGTTCAGTGGGT	AGAGCTATGTCA------------CCTGTGAAAACA	SCVACEDRGSVG	RAMS----PVKT
GCCGAGTGTCTGGAGGAGGAGGAGGAGGAGGAGGAA	GCTGAGTGTCTT------------GTGGAAGAGGAG	AECLEEEEEEEE	AECL----VEEE
CCAGCTGGCCAGAGCTGGGCGAGACGCTGC	CAGCTGGCAGAG------CTGGAGGAGACA	PAGQSWARRC	QLAE--LEET
CAGCAGCAGCAACTGCAGCAGCAGCGA	CAGCAGCAGCAA---CAACAGCAGCAG	QQQQLQQQR	QQQQ-QQQQ
AGGAAGAAAACGAAGAAGAAGAAGAAA	AGGAAGAAAACA---AAGAAGAAGAAG	RKKTKKKKK	RKKT-KKKK
GAGGAAGAGAAGAAGGAGGAGGAAGAGGAG	GAAGAGGAGAAG------GAGGAGGAGAAA	EEEKKEEEEE	EEEK--EEEK
CAAGACCTGAAGGAGGAGGAGGAGGAA	CAAGACCTGAAG---GAGGAGGAAGAG	QDLKEEEEE	QDLK-EEEE
AAGAAAGCCCTGAAAAAGAAGAAGAAA	AAGAAAGCCCTG---AAAAAGAAGAAG	KKALKKKKK	KKAL-KKKK
GAGATGGCCCAGTCCTCTTCCTCCTCCTCT	GAGATGGCCCAG------ACCTCTTCTTCC	EMAQSSSSSS	EMAQ--TSSS
ACTCCAGAAATGCTTCCCCATGTTCAA	ATTCCAGAAACG---CCTAAGCCTAGT	TPEMLPHVQ	IPET-PKPS
GTTGCTGCTGCTGCTGTTGCTGCTGCCGCC	GTTGCTGCTGCT------GCTGCTGTTGCT	VAAAAVAAAA	VAAA--AAVA
CTCTGCCCCGCTCTACTGCTGCTGCTA	CTCTGCCCCGCT---CTACTGCTGCTG	LCPALLLLL	LCPA-LLLL
CCTTCAGATCTCCAGTCGGATCCTGAAGAA	CCCACCGATCTT------CCGCCTGCTTCT	PSDLQSDPEE	PTDL--PPAS
AAGAAAACACAGGCCGCCGCCGCTGCCGCCGCC	AAGAAAAAACAG---------GCCGCCGCTGCT	KKTQAAAAAAA	KKKQ---AAAA
ATGACCTACAGCGGTGGCGGCGGCGGG	ATGACCTACAGC---GGAGGCGGCGGC	MTYSGGGGG	MTYS-GGGG
GACGAGCCGCTCCGCAAGAGGCCCCGCCGAGACGGG	GATTTTATTTTT------------GTGTTGTGTGCC	DEPLRKRPRRDG	DFIF----VLCA
TTGCCTGAACAAGAGGAGGAGGAGGAA	TTGCCTGAACAA---GAGGAAGAGGAG	MPEQEEEEE	LPEQ-EEEE
GAAGGCCACCTTGATGATGACGATGAC	GAAGGCCACCTT---GATGATGACGAT	EGHLDDDDD	EGHL-DDDD
CAGCTTCTCCTGCAGCAGCAGCAGCAA	CAGCTTCTTCTG---CAGCAGCAGCAG	QLLLQQQQQ	QLLL-QQQQ
GCACCAGGCATGGAGGAGGAGGAGGAGGAGGAAGAA	GCACCAGGCATG------------GAGGAAGAGGAG	APGMEEEEEEEE	APGM----EEEE
CCACTGCCTTTGCCCGAGCCCCAACCTGAGCCTCAG	CCACTGCCCCTG------------CCCGAGCCCCAA	PLPLPEPQPEPQ	PLPL----PEPQ
TTCCAGGTGCGAGTCAAGGTTGGAAAG	TTCCAGAATGAA---CACACACGGGCA	FQVRVKVGK	FQNE-HTRA
ATCTGGAAACCTCTTGAGTGCGGCAGTGCT	GAAAATGGGACT------CTGGTGAAGAGC	IWKPLECGSA	ENGT--LVKS
CCACCACCGCAGGAGGAGGAGGAGGAA	CCACCACCGCAG---GAGGAGGAGGAG	PPPQEEEEE	PPPQ-EEEE
AGAGGACACAGATACAAGGAAGAGAAA	CGAGGACACAGA---CGTGAGGAAGAG	RGHRYKEEK	RGHR-REEE
TCGGACCAGCTGGGCCAGGGCCAGGGCCAA	TCAGACCAGCTG------GGCCAGGGCCAG	SDQLGQGQGQ	SDQL--GQGQ
GGCAGCCAGGGAGAGGAGGAGGAGGAA	GGCAGCCAGGGA---GAGGAGGAAGAG	GSQGEEEEE	GSQG-EEEE
CTCGAGTTTGGGGAGGAGGAGGAGGAAGAA	CTCGAGTTTGGT------GACGATGAGGAG	LEFGEEEEEE	LEFG--DDEE
AGATCCATGTTGCTGGGAGCAGTGGGGAGA	GACCCATTGCTT------GGGAGCAGTGAG	RSMLLGAVGR	DPLL--GSSE
GGCACCTTTTACCAGCAGCAGCAGCAA	GGCACCTTTTAC---CAGCAGCAGCAG	GTFYQQQQQ	GTFY-QQQQ
GATGCGGCCAATATGATATCCCCCAAA	GATGTGGCCAGT---ATTAGAACCCTC	DAANMISPK	DVAS-IRTL
GATATTCCATCTCTTCCACCTTTACCACCCCTC	GATATCCCATCT---------CTTCCACCTTTA	DIPSLPPLPPL	DIPS---LPPL
TATGGCCTGAGCGCAGCGGCCGCCGCG	TATGGCCTGAGC---GCAGCGGCCGCC	YGLSAAAAA	YGLS-AAAA
GAGGAGGAGGAGGATGACGAAGACGATGAT	GAGGAAGAGGAG------GAGGACGACGAC	EEEEDDEDDD	EEEE--EDDD
AAGAGTGAGGGAGAGGAAGAGGAGGAA	AAGAGTGAGGGA---GAGGAAGAGGAG	KSEGEEEEE	KSEG-EEEE
GGCTACCCTACTCCCTTCTCCGAGCTC	CCTGCCGAGATC---CTCAGCCCAGAG	GYPTPFSEL	PAEI-LSPE
GAGCAGGTGGCAGAGGAAGAAGAGGAA	GAGCAGGTAGCA---GAGGAGGAAGAG	EQVAEEEEE	EQVA-EEEE
CCCAAAACTGTGCTAGAAAGTGGGGGC	GCGGACGGCGGG---GAGGAGGCTGCG	PKTVLESGG	ADGG-EEAA
GGCACTGTTATTCCACCTCCCCCACCC	GGCACTGTTATT---CCACCTCCCCCA	GTVIPPPPP	GTVI-PPPP
GTATACAAGCACCAAGGCTCTAGGAAGCAGGCC	GTGTACAAGCAC---------AAACGCTCTGGG	VYKHQGSRKQA	VYKH---KRSG
ATAGAGACAATAGAACCAGAACCAGAACCG	ATAGAGACAATA------GAACCAGAACCA	IETIEPEPEP	IETI--EPEP
CCATGGCCAGAGCTGCCAGCCCCAGCCCCC	CCATGGCCAGAG------CCGCCAGCCCCA	PWPELPAPAP	PWPE--PPAP
ATAACCGGGAGTCAGCAGCAGCAGCAA	ATAACTGGGAGT---CAGCAGCAGCAG	ITGSQQQQQ	ITGS-QQQQ
CGGATGGATGAGGATGGTCAGTCCTGT	CGGATGGATGAG---GGCCAGCAGTCC	RMDEDGQSC	RMDE-GQQS
CCACAGATACTGCAGCAGCAGCAGCAGCAGCAACAA	CAGCAGATCCTG------------CAGCAGCAGCAG	PQILQQQQQQQQ	QQIL----QQQQ
CCACGGGGCCGAGAGAAGAGGCGTAGA	CCACGAGGCCGG---AAGAGGAGGCAT	PRGREKRRR	PRGR-KRRH
ATGAAGAACAAGGTGTCAGACGTATATCCG	AAGAAGAACAAG------CCATGTCACAAA	MKNKVSDVYP	KKNK--PCHK
GAGCCGGAAGACGAGGACGATGAGGAA	GAGCCGGAAGAC---GAGGACGACGAG	EPEDEDDEE	EPED-EDDE
GAGAGTAGACTGAAATACTATTTCAATGTT	GAAGGAGCTGTT------TACCATGTCACC	ESRLKYYFNV	EGAV--YHVT
AACAAAAACCTAAACCTCCCTTCTCTG	GCTCAGCATCTG---CTCCGGATCTCT	NKNLNLPSL	AQHL-LRIS
GATGGCAGTACACAACCCCAAATTGAGACA	TTCTTCACTTCA------ATCCTCCTCCTT	DGSTQPQIET	FFTS--ILLL
TCAGGCGGCTTCGCGAGCGCTCTGGAGCGA	ACTTTTGGTTTT------GAATTAATTCAG	SGGFASALER	TFGF--ELIQ
CGAGATATTTACCCCCTGTTGCTGCTACTGCTA	CGAGATGTCTAC---------CTCCTGTTGCTG	RDIYPLLLLLL	RDVY---LLLL
GCCGGGGCCGGAGCTTCTGCTGCTGCCGCC	GCCGGGGCCGGA------GCTGCTGCTGCT	AGAGASAAAA	AGAG--AAAA
GCCGCGGGCTCCGCCGCTGCCGCCGCCGCT	GCTGCGGGCTCC------GCCGCTGCTGCC	AAGSAAAAAA	AAGS--AAAA
CCTGCAGGCAGCCGCACGGCCATCAGCCAG	CCACACAATGGT------GGGATCTCCAGC	PAGSRTAISQ	PHNG--GISS
CCCATTGCCGAGGAACCAGCCCTGGGCCCT	CCAGCTGGAGAA------GCAACAGAAGAG	PIAEEPALGP	PAGE--ATEE
TCAGGTGAGGTCTGGAAGGCAGAGGACACTGAGGAT	TCAGGTAAGGTC------------ACCGAGGAAGAG	SGEVWKAEDTED	SGKV----TEEE
GTCAGAACTGAAGGTGACCCTGGTGACCCTTCC	GTTATAGCTAAA---------GGTGAACCTTGT	VRTEGDPGDPS	VIAK---GEPC
GTTGGCCGTCCTGGAACTGGTACAAGC	GTTAGCGGTCCT---ACAATTACTTCA	VGRPGTGTS	VSGP-TITS
GGTGGTGGTAAAGAGCAGCAGCAGCAGCAA	GGCGGCGGTGGT------AAAGAGCAACAG	GGGKEQQQQQ	GGGG--KEQQ
CCCGGTGAACCCGCGCAGGCTGCTCAGAATGCC	CAGGGCCAGCCC---------GCCCAGACTGCT	PGEPAQAAQNA	QGQP---AQTA
AACATAGAACACTTGCCTACAAAGGAGGAA	AATTTAGAACAC------TCATCTAGGAAG	NIEHLPTKEE	NLEH--SSRK
CATGCGCTCAGCACTGCTACATCCGGGGCAGAG	AATAAGCGCCGG---------AGGGGCTGTCCC	HALSTATSGAE	NKRR---RGCP
CAAGGTCCTTCACCACCACCACCACCT	CAAGGTCCTTCA---CCACCACCACCA	QGPSPPPPP	QGPS-PPPP
GCCCTGGTGGACAATATTGTCATCAGCCATGAG	TCAATATACTCA---------GTGGCCGGAACC	ALVDNIVISHE	SIYS---VAGT
TACAGACAGACCGAGGGCGAGGGCGAGGGT	GAAAGGCATCTC------GGGCCCGAGGAC	YRQTEGEGEG	ERHL--GPED
GAGAGTGACCAAGAGGAGGAGGAGGAA	GAGAGTGACCAA---GAGAATGAGGAG	ESDQEEEEE	ESDQ-ENEE
CCACCAATGATGTCCAGTTCATCTTCC	CCACCAATGGTG---TCCAGTTCATCT	PPMMSSSSS	PPMV-SSSS
CTGCAGACAAAAAACCCTACCACTATGACG	CTGCAGCCAAAA------ACCTCTACCACT	MQTKNPTTMT	LQPK--TSTT
GAGAGTGCTCGCGGAGGAGGAGGAGGC	GAGAGTGCTCGC---GGAGGAGGAGGA	ESARGGGGG	ESAR-GGGG
CCACTGTTAGTTCCTTCTTCCTCCTCT	CCACTGTCAGTT---CATTCTTCTTCC	PLLVPSSSS	PLSV-HSSS
GGCCAGCCAGAGATGGGGACACAGACTGGT	GGCCAGCCAGAG------ACGGAGACAGAG	GQPEMGTQTG	GQPE--TETE
TATCGGAACAAGCAGCAGCAGCAACAGCAG	TATCGGAACAAG------CAGCAGCAGCAA	YRNKQQQQQQ	YRNK--QQQQ
GCAGTTCCACAGGCCTCTGTGCCTGGTCTCCGA	GCAGCCCCACAG---------CCCCCTGTGGCT	AVPQASVPGLR	AAPQ---PPVA
GCGCACGCCTGGCCGACGGCCGCCTTG	GCGCACGTCTGG---CTGGCGGCCGCC	AHAWPTAAL	AHVW-LAAA
GGTCTCCCGAACGGCGGCGGCGGCGGCGGA	GGTCTTCCGAAC------GGCGGCGGCGGC	GLPNGGGGGG	GLPN--GGGG
GCAGGGGCTGCAGTAGGGGGCAGCGGCGGTGGTGGT	GCAGGGGCTGCA------------GGAGGGGGCAGC	AGAAVGGSGGGG	AGAA----GGGS
GTGTTGCTGCTACTACCGCTGCCGCTACCA	GTGTTGCTGCTA------CTGCCGCTGCCG	VLLLLPLPLP	VLLL--LPLP
AGCTTGTCACTGCAGCAGCAGCAGCAA	AGCCTGTCACTG---CAGCAGCAGCAG	SLSLQQQQQ	SLSL-QQQQ
GAAACAGGAGGCCACAAACAACCTAACAAAACC	GAAACAGGAGGC---------CCCAAACCAGCT	ETGGHKQPNKT	ETGG---PKPA
TTGGTGGATTCGGAAGAGGAGGAGGAAGAAGAA	TTGGTGGATTCG---------GAAGAGGAGGAG	MVDSEEEEEEE	LVDS---EEEE
AAATCCCAGGGCAGCAATTACAACAGCAATTACAAT	AAACCCCAAGGC------------AGCAATTATAAC	KSQGSNYNSNYN	KPQG----SNYN
AAAATTAGTATGCTGTTTTTCCTCCTTCTA	GCGCCCGGTCCC------CGCTCCGGCCCC	KISMLFFLLL	APGP--RSGP
CCTCCTGCCGCACCACCGCCGCCGCCA	CCTCCCGCCGCG---CCCCCGCCGCCG	PPAAPPPPP	PPAA-PPPP
AGACGAGAGTTTAGAATGGGTGTATTC	GACATTGAATTC---ATGAAGCGCCTA	RREFRMGVF	DIEF-MKRL
GCAGCATCACCAACGCCTCCGCCACCT	GCAGCATCACCA---CCGCCTCCGCCA	AASPTPPPP	AASP-PPPP
GGAGTTCCCGAGGCCGCCGCCGCCGCT	GGAGTTCCTGAG---GCCGCCGCTGCC	GVPEAAAAA	GVPE-AAAA
AAGTGCAACGACAGCAGTGTCTACTAT	AAGTGCAACAAC---AGCGTTGTCTAC	KCNDSSVYY	KCNN-SVVY
TCTCCTGAATGGGAGGAAGAGGAGGAA	TCCCCTGAGTGG---GAGGAAGAGGAG	SPEWEEEEE	SPEW-EEEE
TCAACTCAAGCAAGGAGAGACAGAGGGAATGAC	TCAACGCAAGCA---------CAGGGAAAAAGA	STQARRDRGND	STQA---QGKR
GGAGACCTCGGCGTGGCCCCTCAGGCA	CAGGACACGGGC---GGCCCCTCCTTG	GDLGVAPQA	QDTG-GPSL
AGCCGCGGCCGCCCGGAGACCTCGGCGTGGCCC	GATGCAGGACGG---------GGCGTCCCTGAG	SRGRPETSAWP	DAGR---GVPE
AGTGCAGCCCGGGCGGCTGCGGCGGCC	AGTGCAGCCCGG---GCGGCTGCGGCG	SAARAAAAA	SAAR-AAAA
GATGAAGAGTATGAGGAGGAGGAAGAG	GAGGAGGAGTAT---GATGAAGAGGAA	DEEYEEEEE	EEEY-DEEE
TCGATGGCGCACCCTCCTCCTCCTCCTCCTCCC	TCGATGGCGCAC---------CCTCCTCCTCCT	SMAHPPPPPPP	SMAH---PPPP
GCCCAGCAGCAGGCCACTAAACCATCT	GCCCAGCAGCAG---GTGAGGGTGGGA	AQQQATKPS	AQQQ-VRVG
TCGGACACACCTTCATCCAGCAGCAGT	TCAGACACACCT---GCATCCAGCAGC	SDTPSSSSS	SDTP-ASSS
CAGCTCCTCCTTCAACAGCAGCAACAGCAG	CAGCTCCTCCTT------CAGCAGCAGCAA	QLLLQQQQQQ	QLLL--QQQQ
