wid.1	wid.2	amino_acid.1	amino_acid.2
AGGGACCAAGTATTACAGAGGAGGGGT	GAAAGACAGATT---CCGAGGAGAGGT	RDQVLQRRG	ERQI-PRRG
ACACTGGAAGGAAGGGGACAGCTGAAG	CTGGAGGAAGGG---GGACAGCTGAAG	TLEGRGQLK	LEEG-GQLK
GACCATACTACCCCAGGGACTGTGCCAGCAGGGCCC	CTAGAGACACAC------------CTCCAGCACCCA	DHTTPGTVPAGP	LETH----LQHP
GGGCGGGACAACGGACAGTTCTTAAGC	CCGGGACAACGG---ACAGTTCTTAAG	GRDNGQFLS	PGQR-TVLK
TGTGACATGAAGTCCATCATCAAAGCC	GCCACTCTCCGC---CTCCTCACAGCC	CDMKSIIKA	ATLR-LLTA
AAACCGACGTCACTGTTGTCTACCTTG	CTGAACTCATCT---TTGTCCACTTTG	KPTSLLSTL	LNSS-LSTL
CCATCTTCTGATATAAACAGTATATATAAG	TCTAATACAGAC------ACTATATATAAG	PSSDINSIYK	SNTD--TIYK
CATAGACAAGGGATGAGCCAGGGAACC	ATAGACAAGGAT---GAGCCAGGAACT	HRQGMSQGT	IDKD-EPGT
ACTGAATTTACTATTAGGGAAAGGGCT	GAACGTTTTGAA---AGGGAAAGGGCT	TEFTIRERA	ERFE-RERA
GGGAAATCCGCGGTGTGGGCTCACATT	AACGTCAGTCGG---CAGGCTCATATT	GKSAVWAHI	NVSR-QAHI
GTTGATGAAAGTGCAAAGGTGTCTCTGGAATCT	ACTGGAATCTCA---------ACAATGCTTGCT	VDESAKVSLES	TGIS---TMLA
TCTAGGAAACCTGCAAAGCGTAAACTG	ATGCAAACTCCA---AAGCAGAAACTG	SRKPAKRKL	MQTP-KQKL
TCTCAGGAAGGGTCCCAGTGCCCTGTAGGCCTG	GAAGGCCCCGGA---------CCTGCAGGGATG	SQEGSQCPVGL	EGPG---PAGM
TCTGCTTCATCTTCTCCTTTCAATCCG	GCTTCATCCTCT---CCTTTCAGTCCG	SASSSPFNP	ASSS-PFSP
TGTACTCAGCTGCAGCTTCTAAATCCA	AAACACGACCTT---CTTACCACTCTG	CTQLQLLNP	KHDL-LTTL
TTGCTGCTGCTGGCGCTGTGCTGCAGC	CTGCTGCTGGTG---CTGTACTGCAGC	MLLLALCCS	LLLV-LYCS
TCTTTAAATCTGGTCAGTCTACCACCTAAG	AGCCTGGCAGTC------CTGCCGACTAAG	SLNLVSLPPK	SLAV--LPTK
GTTAGCTCAACCAATGGAGAGCTGAAT	AGATCTTTAACA---GCAGAGTGGTTT	VSSTNGELN	RSLT-AEWF
TGGGTAAGTGGTCTACCAAGCCCACAC	GAAATTGAACCA---CCACCCCCTGAA	WVSGLPSPH	EIEP-PPPE
ACGGATAGCTTGGATGCCCGTGGTCAT	GACCTCTCGATT---GCCCGTGGTCAT	TDSLDARGH	DLSI-ARGH
AGGAGACGACGGACGTTTCGTGGAGACTAC	CCTCGGAAAAAG------AGACCATCCTAT	RRRRTFRGDY	PRKK--RPSY
ACTTCTTTACAGATTTTGACTTTAAAT	TCAGAACTGCCA---AAGACGGTTTCT	TSLQILTLN	SELP-KTVS
CGTGGGCTGGCCATCGGCAGACGCTAC	GTGGCTTGCCCT---CGGCAGCGCTAT	RGLAIGRRY	VACP-RQRY
ATATCCATTAAGCAAGAGGACACCATT	TGCCGCTGGAGA---GACGGCACTGTT	ISIKQEDTI	CRWR-DGTV
TGTAGAGCAGGAAGAAAAGGCCAGACC	ACAACAGTGGGA---AAAGGCCAGACT	CRAGRKGQT	TTVG-KGQT
