wid.1	wid.2	amino_acid.1	amino_acid.2
CAAATACCAGACGGAGGAGGAGGAGGT	CAAATACCAGACGGAGGAGCTGGA---	QIPDGGGGG	QIPDGGAG-
TGCTACGTGGGTGGGCTTAGAGCCATGAGGAGCACA	TACCTGTGTGGACGCCACACGGAC------------	CYVGGLRAMRST	YLCGRHTD----
TCCCAGCAGCAGGGTGGCGGCGGCGGCGGG	GCCCAGCACCAGGGTGGCAGTGGC------	SQQQGGGGGG	AQHQGGSG--
AGCTGTGTCGCCTGTGAAGACAGAGGTTCAGTGGGT	AGAGCTATGTCACCTGTGAAAACA------------	SCVACEDRGSVG	RAMSPVKT----
GCCGAGTGTCTGGAGGAGGAGGAGGAGGAGGAGGAA	GCTGAGTGTCTTGTGGAAGAGGAG------------	AECLEEEEEEEE	AECLVEEE----
CCAGCTGGCCAGAGCTGGGCGAGACGCTGC	CAGCTGGCAGAGCTGGAGGAGACA------	PAGQSWARRC	QLAELEET--
CAGCAGCAGCAACTGCAGCAGCAGCGA	CAGCAGCAGCAACAACAGCAGCAG---	QQQQLQQQR	QQQQQQQQ-
AGGAAGAAAACGAAGAAGAAGAAGAAA	AGGAAGAAAACAAAGAAGAAGAAG---	RKKTKKKKK	RKKTKKKK-
GAGGAAGAGAAGAAGGAGGAGGAAGAGGAG	GAAGAGGAGAAGGAGGAGGAGAAA------	EEEKKEEEEE	EEEKEEEK--
CAAGACCTGAAGGAGGAGGAGGAGGAA	CAAGACCTGAAGGAGGAGGAAGAG---	QDLKEEEEE	QDLKEEEE-
AAGAAAGCCCTGAAAAAGAAGAAGAAA	AAGAAAGCCCTGAAAAAGAAGAAG---	KKALKKKKK	KKALKKKK-
GAGATGGCCCAGTCCTCTTCCTCCTCCTCT	GAGATGGCCCAGACCTCTTCTTCC------	EMAQSSSSSS	EMAQTSSS--
ACTCCAGAAATGCTTCCCCATGTTCAA	ATTCCAGAAACGCCTAAGCCTAGT---	TPEMLPHVQ	IPETPKPS-
GTTGCTGCTGCTGCTGTTGCTGCTGCCGCC	GTTGCTGCTGCTGCTGCTGTTGCT------	VAAAAVAAAA	VAAAAAVA--
CTCTGCCCCGCTCTACTGCTGCTGCTA	CTCTGCCCCGCTCTACTGCTGCTG---	LCPALLLLL	LCPALLLL-
CCTTCAGATCTCCAGTCGGATCCTGAAGAA	CCCACCGATCTTCCGCCTGCTTCT------	PSDLQSDPEE	PTDLPPAS--
AAGAAAACACAGGCCGCCGCCGCTGCCGCCGCC	AAGAAAAAACAGGCCGCCGCTGCT---------	KKTQAAAAAAA	KKKQAAAA---
ATGACCTACAGCGGTGGCGGCGGCGGG	ATGACCTACAGCGGAGGCGGCGGC---	MTYSGGGGG	MTYSGGGG-
GACGAGCCGCTCCGCAAGAGGCCCCGCCGAGACGGG	GATTTTATTTTTGTGTTGTGTGCC------------	DEPLRKRPRRDG	DFIFVLCA----
TTGCCTGAACAAGAGGAGGAGGAGGAA	TTGCCTGAACAAGAGGAAGAGGAG---	MPEQEEEEE	LPEQEEEE-
GAAGGCCACCTTGATGATGACGATGAC	GAAGGCCACCTTGATGATGACGAT---	EGHLDDDDD	EGHLDDDD-
CAGCTTCTCCTGCAGCAGCAGCAGCAA	CAGCTTCTTCTGCAGCAGCAGCAG---	QLLLQQQQQ	QLLLQQQQ-
GCACCAGGCATGGAGGAGGAGGAGGAGGAGGAAGAA	GCACCAGGCATGGAGGAAGAGGAG------------	APGMEEEEEEEE	APGMEEEE----
CCACTGCCTTTGCCCGAGCCCCAACCTGAGCCTCAG	CCACTGCCCCTGCCCGAGCCCCAA------------	PLPLPEPQPEPQ	PLPLPEPQ----
TTCCAGGTGCGAGTCAAGGTTGGAAAG	TTCCAGAATGAACACACACGGGCA---	FQVRVKVGK	FQNEHTRA-
ATCTGGAAACCTCTTGAGTGCGGCAGTGCT	GAAAATGGGACTCTGGTGAAGAGC------	IWKPLECGSA	ENGTLVKS--
CCACCACCGCAGGAGGAGGAGGAGGAA	CCACCACCGCAGGAGGAGGAGGAG---	PPPQEEEEE	PPPQEEEE-
AGAGGACACAGATACAAGGAAGAGAAA	CGAGGACACAGACGTGAGGAAGAG---	RGHRYKEEK	RGHRREEE-
TCGGACCAGCTGGGCCAGGGCCAGGGCCAA	TCAGACCAGCTGGGCCAGGGCCAG------	SDQLGQGQGQ	SDQLGQGQ--
GGCAGCCAGGGAGAGGAGGAGGAGGAA	GGCAGCCAGGGAGAGGAGGAAGAG---	GSQGEEEEE	GSQGEEEE-
CTCGAGTTTGGGGAGGAGGAGGAGGAAGAA	CTCGAGTTTGGTGACGATGAGGAG------	LEFGEEEEEE	LEFGDDEE--
AGATCCATGTTGCTGGGAGCAGTGGGGAGA	GACCCATTGCTTGGGAGCAGTGAG------	RSMLLGAVGR	DPLLGSSE--
GGCACCTTTTACCAGCAGCAGCAGCAA	GGCACCTTTTACCAGCAGCAGCAG---	GTFYQQQQQ	GTFYQQQQ-
GATGCGGCCAATATGATATCCCCCAAA	GATGTGGCCAGTATTAGAACCCTC---	DAANMISPK	DVASIRTL-
GATATTCCATCTCTTCCACCTTTACCACCCCTC	GATATCCCATCTCTTCCACCTTTA---------	DIPSLPPLPPL	DIPSLPPL---
TATGGCCTGAGCGCAGCGGCCGCCGCG	TATGGCCTGAGCGCAGCGGCCGCC---	YGLSAAAAA	YGLSAAAA-
GAGGAGGAGGAGGATGACGAAGACGATGAT	GAGGAAGAGGAGGAGGACGACGAC------	EEEEDDEDDD	EEEEEDDD--
AAGAGTGAGGGAGAGGAAGAGGAGGAA	AAGAGTGAGGGAGAGGAAGAGGAG---	KSEGEEEEE	KSEGEEEE-
GGCTACCCTACTCCCTTCTCCGAGCTC	CCTGCCGAGATCCTCAGCCCAGAG---	GYPTPFSEL	PAEILSPE-
GAGCAGGTGGCAGAGGAAGAAGAGGAA	GAGCAGGTAGCAGAGGAGGAAGAG---	EQVAEEEEE	EQVAEEEE-
CCCAAAACTGTGCTAGAAAGTGGGGGC	GCGGACGGCGGGGAGGAGGCTGCG---	PKTVLESGG	ADGGEEAA-
GGCACTGTTATTCCACCTCCCCCACCC	GGCACTGTTATTCCACCTCCCCCA---	GTVIPPPPP	GTVIPPPP-
GTATACAAGCACCAAGGCTCTAGGAAGCAGGCC	GTGTACAAGCACAAACGCTCTGGG---------	VYKHQGSRKQA	VYKHKRSG---
ATAGAGACAATAGAACCAGAACCAGAACCG	ATAGAGACAATAGAACCAGAACCA------	IETIEPEPEP	IETIEPEP--
CCATGGCCAGAGCTGCCAGCCCCAGCCCCC	CCATGGCCAGAGCCGCCAGCCCCA------	PWPELPAPAP	PWPEPPAP--
ATAACCGGGAGTCAGCAGCAGCAGCAA	ATAACTGGGAGTCAGCAGCAGCAG---	ITGSQQQQQ	ITGSQQQQ-
CGGATGGATGAGGATGGTCAGTCCTGT	CGGATGGATGAGGGCCAGCAGTCC---	RMDEDGQSC	RMDEGQQS-
CCACAGATACTGCAGCAGCAGCAGCAGCAGCAACAA	CAGCAGATCCTGCAGCAGCAGCAG------------	PQILQQQQQQQQ	QQILQQQQ----
CCACGGGGCCGAGAGAAGAGGCGTAGA	CCACGAGGCCGGAAGAGGAGGCAT---	PRGREKRRR	PRGRKRRH-
ATGAAGAACAAGGTGTCAGACGTATATCCG	AAGAAGAACAAGCCATGTCACAAA------	MKNKVSDVYP	KKNKPCHK--
GAGCCGGAAGACGAGGACGATGAGGAA	GAGCCGGAAGACGAGGACGACGAG---	EPEDEDDEE	EPEDEDDE-
GAGAGTAGACTGAAATACTATTTCAATGTT	GAAGGAGCTGTTTACCATGTCACC------	ESRLKYYFNV	EGAVYHVT--
AACAAAAACCTAAACCTCCCTTCTCTG	GCTCAGCATCTGCTCCGGATCTCT---	NKNLNLPSL	AQHLLRIS-
GATGGCAGTACACAACCCCAAATTGAGACA	TTCTTCACTTCAATCCTCCTCCTT------	DGSTQPQIET	FFTSILLL--
TCAGGCGGCTTCGCGAGCGCTCTGGAGCGA	ACTTTTGGTTTTGAATTAATTCAG------	SGGFASALER	TFGFELIQ--
CGAGATATTTACCCCCTGTTGCTGCTACTGCTA	CGAGATGTCTACCTCCTGTTGCTG---------	RDIYPLLLLLL	RDVYLLLL---
GCCGGGGCCGGAGCTTCTGCTGCTGCCGCC	GCCGGGGCCGGAGCTGCTGCTGCT------	AGAGASAAAA	AGAGAAAA--
GCCGCGGGCTCCGCCGCTGCCGCCGCCGCT	GCTGCGGGCTCCGCCGCTGCTGCC------	AAGSAAAAAA	AAGSAAAA--
CCTGCAGGCAGCCGCACGGCCATCAGCCAG	CCACACAATGGTGGGATCTCCAGC------	PAGSRTAISQ	PHNGGISS--
CCCATTGCCGAGGAACCAGCCCTGGGCCCT	CCAGCTGGAGAAGCAACAGAAGAG------	PIAEEPALGP	PAGEATEE--
TCAGGTGAGGTCTGGAAGGCAGAGGACACTGAGGAT	TCAGGTAAGGTCACCGAGGAAGAG------------	SGEVWKAEDTED	SGKVTEEE----
GTCAGAACTGAAGGTGACCCTGGTGACCCTTCC	GTTATAGCTAAAGGTGAACCTTGT---------	VRTEGDPGDPS	VIAKGEPC---
GTTGGCCGTCCTGGAACTGGTACAAGC	GTTAGCGGTCCTACAATTACTTCA---	VGRPGTGTS	VSGPTITS-
GGTGGTGGTAAAGAGCAGCAGCAGCAGCAA	GGCGGCGGTGGTAAAGAGCAACAG------	GGGKEQQQQQ	GGGGKEQQ--
CCCGGTGAACCCGCGCAGGCTGCTCAGAATGCC	CAGGGCCAGCCCGCCCAGACTGCT---------	PGEPAQAAQNA	QGQPAQTA---
AACATAGAACACTTGCCTACAAAGGAGGAA	AATTTAGAACACTCATCTAGGAAG------	NIEHLPTKEE	NLEHSSRK--
CATGCGCTCAGCACTGCTACATCCGGGGCAGAG	AATAAGCGCCGGAGGGGCTGTCCC---------	HALSTATSGAE	NKRRRGCP---
CAAGGTCCTTCACCACCACCACCACCT	CAAGGTCCTTCACCACCACCACCA---	QGPSPPPPP	QGPSPPPP-
GCCCTGGTGGACAATATTGTCATCAGCCATGAG	TCAATATACTCAGTGGCCGGAACC---------	ALVDNIVISHE	SIYSVAGT---
TACAGACAGACCGAGGGCGAGGGCGAGGGT	GAAAGGCATCTCGGGCCCGAGGAC------	YRQTEGEGEG	ERHLGPED--
GAGAGTGACCAAGAGGAGGAGGAGGAA	GAGAGTGACCAAGAGAATGAGGAG---	ESDQEEEEE	ESDQENEE-
CCACCAATGATGTCCAGTTCATCTTCC	CCACCAATGGTGTCCAGTTCATCT---	PPMMSSSSS	PPMVSSSS-
CTGCAGACAAAAAACCCTACCACTATGACG	CTGCAGCCAAAAACCTCTACCACT------	MQTKNPTTMT	LQPKTSTT--
GAGAGTGCTCGCGGAGGAGGAGGAGGC	GAGAGTGCTCGCGGAGGAGGAGGA---	ESARGGGGG	ESARGGGG-
CCACTGTTAGTTCCTTCTTCCTCCTCT	CCACTGTCAGTTCATTCTTCTTCC---	PLLVPSSSS	PLSVHSSS-
GGCCAGCCAGAGATGGGGACACAGACTGGT	GGCCAGCCAGAGACGGAGACAGAG------	GQPEMGTQTG	GQPETETE--
TATCGGAACAAGCAGCAGCAGCAACAGCAG	TATCGGAACAAGCAGCAGCAGCAA------	YRNKQQQQQQ	YRNKQQQQ--
GCAGTTCCACAGGCCTCTGTGCCTGGTCTCCGA	GCAGCCCCACAGCCCCCTGTGGCT---------	AVPQASVPGLR	AAPQPPVA---
GCGCACGCCTGGCCGACGGCCGCCTTG	GCGCACGTCTGGCTGGCGGCCGCC---	AHAWPTAAL	AHVWLAAA-
GGTCTCCCGAACGGCGGCGGCGGCGGCGGA	GGTCTTCCGAACGGCGGCGGCGGC------	GLPNGGGGGG	GLPNGGGG--
GCAGGGGCTGCAGTAGGGGGCAGCGGCGGTGGTGGT	GCAGGGGCTGCAGGAGGGGGCAGC------------	AGAAVGGSGGGG	AGAAGGGS----
GTGTTGCTGCTACTACCGCTGCCGCTACCA	GTGTTGCTGCTACTGCCGCTGCCG------	VLLLLPLPLP	VLLLLPLP--
AGCTTGTCACTGCAGCAGCAGCAGCAA	AGCCTGTCACTGCAGCAGCAGCAG---	SLSLQQQQQ	SLSLQQQQ-
GAAACAGGAGGCCACAAACAACCTAACAAAACC	GAAACAGGAGGCCCCAAACCAGCT---------	ETGGHKQPNKT	ETGGPKPA---
TTGGTGGATTCGGAAGAGGAGGAGGAAGAAGAA	TTGGTGGATTCGGAAGAGGAGGAG---------	MVDSEEEEEEE	LVDSEEEE---
AAATCCCAGGGCAGCAATTACAACAGCAATTACAAT	AAACCCCAAGGCAGCAATTATAAC------------	KSQGSNYNSNYN	KPQGSNYN----
AAAATTAGTATGCTGTTTTTCCTCCTTCTA	GCGCCCGGTCCCCGCTCCGGCCCC------	KISMLFFLLL	APGPRSGP--
CCTCCTGCCGCACCACCGCCGCCGCCA	CCTCCCGCCGCGCCCCCGCCGCCG---	PPAAPPPPP	PPAAPPPP-
AGACGAGAGTTTAGAATGGGTGTATTC	GACATTGAATTCATGAAGCGCCTA---	RREFRMGVF	DIEFMKRL-
GCAGCATCACCAACGCCTCCGCCACCT	GCAGCATCACCACCGCCTCCGCCA---	AASPTPPPP	AASPPPPP-
GGAGTTCCCGAGGCCGCCGCCGCCGCT	GGAGTTCCTGAGGCCGCCGCTGCC---	GVPEAAAAA	GVPEAAAA-
AAGTGCAACGACAGCAGTGTCTACTAT	AAGTGCAACAACAGCGTTGTCTAC---	KCNDSSVYY	KCNNSVVY-
TCTCCTGAATGGGAGGAAGAGGAGGAA	TCCCCTGAGTGGGAGGAAGAGGAG---	SPEWEEEEE	SPEWEEEE-
TCAACTCAAGCAAGGAGAGACAGAGGGAATGAC	TCAACGCAAGCACAGGGAAAAAGA---------	STQARRDRGND	STQAQGKR---
GGAGACCTCGGCGTGGCCCCTCAGGCA	CAGGACACGGGCGGCCCCTCCTTG---	GDLGVAPQA	QDTGGPSL-
AGCCGCGGCCGCCCGGAGACCTCGGCGTGGCCC	GATGCAGGACGGGGCGTCCCTGAG---------	SRGRPETSAWP	DAGRGVPE---
AGTGCAGCCCGGGCGGCTGCGGCGGCC	AGTGCAGCCCGGGCGGCTGCGGCG---	SAARAAAAA	SAARAAAA-
GATGAAGAGTATGAGGAGGAGGAAGAG	GAGGAGGAGTATGATGAAGAGGAA---	DEEYEEEEE	EEEYDEEE-
TCGATGGCGCACCCTCCTCCTCCTCCTCCTCCC	TCGATGGCGCACCCTCCTCCTCCT---------	SMAHPPPPPPP	SMAHPPPP---
GCCCAGCAGCAGGCCACTAAACCATCT	GCCCAGCAGCAGGTGAGGGTGGGA---	AQQQATKPS	AQQQVRVG-
TCGGACACACCTTCATCCAGCAGCAGT	TCAGACACACCTGCATCCAGCAGC---	SDTPSSSSS	SDTPASSS-
CAGCTCCTCCTTCAACAGCAGCAACAGCAG	CAGCTCCTCCTTCAGCAGCAGCAA------	QLLLQQQQQQ	QLLLQQQQ--
