wid.1	wid.2	amino_acid.1	amino_acid.2
AGGGACCAAGTATTACAGAGGAGGGGT	---GAAAGACAGATTCCGAGGAGAGGT	RDQVLQRRG	-ERQIPRRG
ACACTGGAAGGAAGGGGACAGCTGAAG	---CTGGAGGAAGGGGGACAGCTGAAG	TLEGRGQLK	-LEEGGQLK
GACCATACTACCCCAGGGACTGTGCCAGCAGGGCCC	------------CTAGAGACACACCTCCAGCACCCA	DHTTPGTVPAGP	----LETHLQHP
GGGCGGGACAACGGACAGTTCTTAAGC	---CCGGGACAACGGACAGTTCTTAAG	GRDNGQFLS	-PGQRTVLK
TGTGACATGAAGTCCATCATCAAAGCC	---GCCACTCTCCGCCTCCTCACAGCC	CDMKSIIKA	-ATLRLLTA
AAACCGACGTCACTGTTGTCTACCTTG	---CTGAACTCATCTTTGTCCACTTTG	KPTSLLSTL	-LNSSLSTL
CCATCTTCTGATATAAACAGTATATATAAG	------TCTAATACAGACACTATATATAAG	PSSDINSIYK	--SNTDTIYK
CATAGACAAGGGATGAGCCAGGGAACC	---ATAGACAAGGATGAGCCAGGAACT	HRQGMSQGT	-IDKDEPGT
ACTGAATTTACTATTAGGGAAAGGGCT	---GAACGTTTTGAAAGGGAAAGGGCT	TEFTIRERA	-ERFERERA
GGGAAATCCGCGGTGTGGGCTCACATT	---AACGTCAGTCGGCAGGCTCATATT	GKSAVWAHI	-NVSRQAHI
GTTGATGAAAGTGCAAAGGTGTCTCTGGAATCT	---------ACTGGAATCTCAACAATGCTTGCT	VDESAKVSLES	---TGISTMLA
TCTAGGAAACCTGCAAAGCGTAAACTG	---ATGCAAACTCCAAAGCAGAAACTG	SRKPAKRKL	-MQTPKQKL
TCTCAGGAAGGGTCCCAGTGCCCTGTAGGCCTG	---------GAAGGCCCCGGACCTGCAGGGATG	SQEGSQCPVGL	---EGPGPAGM
TCTGCTTCATCTTCTCCTTTCAATCCG	---GCTTCATCCTCTCCTTTCAGTCCG	SASSSPFNP	-ASSSPFSP
TGTACTCAGCTGCAGCTTCTAAATCCA	---AAACACGACCTTCTTACCACTCTG	CTQLQLLNP	-KHDLLTTL
TTGCTGCTGCTGGCGCTGTGCTGCAGC	---CTGCTGCTGGTGCTGTACTGCAGC	MLLLALCCS	-LLLVLYCS
TCTTTAAATCTGGTCAGTCTACCACCTAAG	------AGCCTGGCAGTCCTGCCGACTAAG	SLNLVSLPPK	--SLAVLPTK
GTTAGCTCAACCAATGGAGAGCTGAAT	---AGATCTTTAACAGCAGAGTGGTTT	VSSTNGELN	-RSLTAEWF
TGGGTAAGTGGTCTACCAAGCCCACAC	---GAAATTGAACCACCACCCCCTGAA	WVSGLPSPH	-EIEPPPPE
ACGGATAGCTTGGATGCCCGTGGTCAT	---GACCTCTCGATTGCCCGTGGTCAT	TDSLDARGH	-DLSIARGH
AGGAGACGACGGACGTTTCGTGGAGACTAC	------CCTCGGAAAAAGAGACCATCCTAT	RRRRTFRGDY	--PRKKRPSY
ACTTCTTTACAGATTTTGACTTTAAAT	---TCAGAACTGCCAAAGACGGTTTCT	TSLQILTLN	-SELPKTVS
CGTGGGCTGGCCATCGGCAGACGCTAC	---GTGGCTTGCCCTCGGCAGCGCTAT	RGLAIGRRY	-VACPRQRY
ATATCCATTAAGCAAGAGGACACCATT	---TGCCGCTGGAGAGACGGCACTGTT	ISIKQEDTI	-CRWRDGTV
TGTAGAGCAGGAAGAAAAGGCCAGACC	---ACAACAGTGGGAAAAGGCCAGACT	CRAGRKGQT	-TTVGKGQT
