wid.1	wid.2	amino_acid.1	amino_acid.2
AAGAGTAGC	AAAAGT---	KSS	KS-
GGACCTGGG	GGGTCT---	GPG	GS-
AGTTCACGGGCG	AGTCCA------	SSRA	SP--
TCAACACCCACTCCAACT	TCAATA------------	STPTPT	SI----
GTGGGTCCGGGC	GTGGGT------	VGPG	VG--
GAAGGCCAAGGT	GAAGGC------	EGQG	EG--
GTTGGTGTC	GCACCT---	VGV	AP-
TCAGAGCCTGAA	TCGGAG------	SEPE	SE--
CGGCTGCTA	CGGCCG---	RLL	RP-
ATGGGGTCACCT	CTGGAG------	MGSP	LE--
ACTGCGGCA	ACAGCG---	TAA	TA-
GGCCTCCTG	GGACTC---	GLL	GL-
CCCAGAGGAGAGAGG	CCCAGA---------	PRGER	PR---
GATTTTAGA	GAGTCT---	DFR	ES-
TATTCTTCCTCTTCTTCC	TATTCT------------	YSSSSS	YS----
CCTGTTGTG	CCTGTT---	PVV	PV-
TCTCAGCAA	TCTCAG---	SQQ	SQ-
TCTCTTGGGGGC	AACACT------	SLGG	NT--
GATCCTAAGAAA	GATCTT------	DPKK	DL--
GAAAATGCA	GAAAGT---	ENA	ES-
CTGTCATCG	CTTTCA---	MSS	LS-
TTCTGGTGA	GTCTAG---	FW*	V*-
TCAGGTGGC	TCAGGT---	SGG	SG-
ACCATCGCACAG	ACCACC------	TIAQ	TT--
GAGCCTGTGGTGCCC	GAGCCT---------	EPVVP	EP---
CACATTGCGTCA	TACAGT------	HIAS	YS--
GATGGACTC	GATAGA---	DGL	DR-
CTGGAGGAA	CTGGAG---	MEE	LE-
GACGAGGAA	GACGAG---	DEE	DE-
ATCGTAAAC	ATGTCA---	IVN	MS-
CAGGCGGCA	CAGGCG---	QAA	QA-
GGCGTGCTT	GGTTGG---	GVL	GW-
CAGGGTGGCGGC	CAGGGT------	QGGG	QG--
GCCCTGATCCACTTCCTC	GCCCTG------------	ALIHFL	AL----
AATGAAAAGGATGAG	AATGAA---------	NEKDE	NE---
GCACCCCCA	GCACCC---	APP	AP-
GAAGTAAAAGTT	GAAGTA------	EVKV	EV--
ATGTTTGAG	ATGACT---	MFE	MT-
CCGGGTGGA	CCAGGT---	PGG	PG-
AGTTTTTCC	AGGGAT---	SFS	RD-
CTTGCAGCAGCC	CTTGCA------	LAAA	LA--
CCGCTGAGA	GCTGAG---	PLR	AE-
CCAAGTTCC	CCAAGT---	PSS	PS-
GTTACCACT	GTTACC---	VTT	VT-
CTTCCTCAG	CTTCTT---	LPQ	LL-
CTCTCGTCAGTCTCA	CTCTCG---------	LSSVS	LS---
CACGGAGGC	CATGGA---	HGG	HG-
CAGAAGAAA	CAGAAG---	QKK	QK-
GTGGGATAG	TACTGA---	VG*	Y*-
CGGGCCGCG	CGGGCC---	RAA	RA-
GAAGGCCCG	GAAGTC---	EGP	EV-
CCAAATAAA	CCACGT---	PNK	PR-
GCAGAGGCC	GCAGGG---	AEA	AG-
GCGGAGGAGGAA	GCGGAG------	AEEE	AE--
CTCGACGAT	CTTGAC---	LDD	LD-
GCTACTACG	GCTGTT---	ATT	AV-
GGGGCCGCAGCT	GGGGCC------	GAAA	GA--
GCCTCCTCT	GCCTCC---	ASS	AS-
AAATGTGAA	AAATCT---	KCE	KS-
GCCCTGCCAGGGCTC	GCCCTG---------	ALPGL	AL---
ACCTCCTCA	ACCTCC---	TSS	TS-
AGGGAAGAG	AGGGAA---	REE	RE-
GAAAGCTCA	AAGCTC---	ESS	KL-
GATGAAGAG	GATGAA---	DEE	DE-
GAGGACGAT	GAGGAC---	EDD	ED-
CTGAAAAAG	CTGAAA---	MKK	LK-
GTGGACCTG	GTGACC---	VDL	VT-
AGCCTGCGC	TCTCCG---	SLR	SP-
CCCACCCAGACG	CCAGAC------	PTQT	PD--
GTCAGCAGT	GTCAGC---	VSS	VS-
GGGGCAGCT	GGGACA---	GAA	GT-
GTTCCTCAGCCG	GTTCCT------	VPQP	VP--
GTAGAAGAG	ATAGAA---	VEE	IE-
GAGGAGGAGGGGGAA	GAAGAG---------	EEEGE	EE---
AGTTTAGGG	AGTAAA---	SLG	SK-
ACAAATAAC	ATAAAT---	TNN	IN-
GAGAATGCC	GAGATT---	ENA	EI-
CTTGATTTCAGA	AAATTT------	LDFR	KF--
AGCGGCGGT	AGCGGC---	SGG	SG-
GCCGGCGGA	GCGGGC---	AGG	AG-
ATGGAGGAA	ATTGAG---	MEE	IE-
GACGGTGGC	GACAGT---	DGG	DS-
CACTTGAGA	AACTCG---	HLR	NS-
AATGTGAGCCCC	AATGGG------	NVSP	NG--
CTTTTCTGG	ATTTCC---	LFW	IS-
AAGGAGGAA	AAGGAG---	KEE	KE-
CGCCTCCTA	CGCCTC---	RLL	RL-
CTTTGTAAACGATACCCA	GTGAGT------------	LCKRYP	VS----
GCTCTACTG	GCTCTA---	ALL	AL-
GGCCGCAGA	GGTCGC---	GRR	GR-
CTCCAGTCGGAT	CTTCCG------	LQSD	LP--
GTGCCCCCT	GTGCCC---	VPP	VP-
GGGATTCGA	GGGGAT---	GIR	GD-
AGGCCAAAG	AGGTCA---	RPK	RS-
AGTGGGGGC	AGTGGG---	SGG	SG-
GAGAGGAACCGC	GAGAGG------	ERNR	ER--
TCAGCACCAGCT	TCAGCA------	SAPA	SA--
GCCACCACCACCACT	GCCACC---------	ATTTT	AT---
CCTATCCAG	CCCAGC---	PIQ	PS-
CAGCTGTTGCTC	CAGCTG------	QLLL	QL--
CCTGTCGTT	CCTGTC---	PVV	PV-
CAGGCCGCCGCCGCT	CAGGCC---------	QAAAA	QA---
ACTCCTCCACCG	ACTCCT------	TPPP	TP--
CAGCCCCCT	CAGCCC---	QPP	QP-
ATCTCTAGC	ATCTCT---	ISS	IS-
AACCAGCACTGA	AACTAG------	NQH*	N*--
GAGCGGTCACTC	GAGCAG------	ERSL	EQ--
CAGGAGCGGGAA	CAGGAG------	QERE	QE--
TCATGTGCC	AACAAT---	SCA	NN-
TTGCAGCAA	TTGCAG---	MQQ	LQ-
CCTCCACCG	CTTCTA---	PPP	LL-
CCCACCACA	CCCACC---	PTT	PT-
CCAGACCTATCCACAGAT	CCAGAC------------	PDLSTD	PD----
AAGCAGTGA	AAGTAG---	KQ*	K*-
TTTGAGGATGAA	TTTGAG------	FEDE	FE--
ATCCCGCTAACCTTTTCT	CTGGAG------------	IPLTFS	LE----
CCAGGAATGGCAGGG	CCAGGA---------	PGMAG	PG---
GGCCACCACCAT	GGCCAC------	GHHH	GH--
CAGAGCCAGCCCCATTCT	CAGAGC------------	QSQPHS	QS----
GGAGAGGAA	GGAGAG---	GEE	GE-
GGCTCCAGCTCT	GGCTCC------	GSSS	GS--
CTCTCCGCCTCT	CTCTCC------	LSAS	LS--
TACTTGTCT	TATCAG---	YLS	YQ-
GATGGGGGA	GACGGG---	DGG	DG-
GTGCGCAGG	GTGCGC---	VRR	VR-
GAGGGTGGG	GAGGAT---	EGG	ED-
CGCTTCCGA	GCTTCC---	RFR	AS-
ATGTTTCGAAGGATCTTG	ATGGAT------------	MFRRIL	MD----
TTGCCCGAGCCCCAACCT	CTGCCC------------	MPEPQP	LP----
ACTCCTCCA	ACTCCT---	TPP	TP-
CCAACATTACCTGAGACT	CCTCCA------------	PTLPET	PP----
GGTTCTTCC	GGTTCT---	GSS	GS-
GAGCCCGTGGCACCT	GAGCCC---------	EPVAP	EP---
CCCTCCTCT	CCCTCC---	PSS	PS-
AGAGCTGCC	AGAGCT---	RAA	RA-
GAAGTGTATGTA	GAAGTG------	EVYV	EV--
CTGTCTTCA	CTGTCT---	MSS	LS-
GGATCTTCC	GGATCT---	GSS	GS-
GAACTGAGC	AGCGAG---	ELS	SE-
CAGCAGCAGCAGGGACAA	CCGCAG------------	QQQQGQ	PQ----
GGCAGACGT	GGCAGA---	GRR	GR-
GACCACCTGCAT	AACAGC------	DHLH	NS--
CCCTCGCTGCCCTCT	CCCTCG---------	PSLPS	PS---
TCCACCACT	TCCACC---	STT	ST-
CAGGAGGAGGAA	CAGGAG------	QEEE	QE--
AGGGAGGAA	AGGGAG---	REE	RE-
GCCCCCCCA	GCTCCC---	APP	AP-
GTGTCCTCT	GTGTCC---	VSS	VS-
GGCTCCTCT	GGCTCC---	GSS	GS-
GCCAGCCGCACCAGT	GCCAGC---------	ASRTS	AS---
GACAAGTACATTGTCACT	GGTGTG------------	DKYIVT	GV----
AGAAGCACAAGT	AGAACC------	RSTS	RT--
TCCCTGCCT	TCCCAG---	SLP	SQ-
CTTGGTGGC	CTCGGT---	LGG	LG-
CCTCAGTGA	CCTTAG---	PQ*	P*-
CCATCTTCC	CCATCT---	PSS	PS-
ACCGCAGCC	ACCGCA---	TAA	TA-
TGGAACCTGTCT	TGGAGC------	WNLS	WS--
AGTGGCGGT	AGTGGC---	SGG	SG-
GCTATTGGCATC	GCTATT------	AIGI	AI--
GGCTTTTTC	GGCTTT---	GFF	GF-
ATACTGACACAC	GTGAGG------	ILTH	VR--
GTGTTCCGG	GTGTCC---	VFR	VS-
GAGGAAGAGGAAAATGAG	GAAGAA------------	EEEENE	EE----
CCACCTCAGCCA	CCACCT------	PPQP	PP--
AGAGGAGGC	AGAGGA---	RGG	RG-
CTACAACAG	CTACAA---	LQQ	LQ-
CTTGGAGGG	CTTGGA---	LGG	LG-
AAACGTGAG	AAATGT---	KRE	KC-
GTCCGCAGGCGA	TACCGC------	VRRR	YR--
TTCGGAAGCCGC	ATCAGA------	FGSR	IR--
GAGGAGGAAGATGAA	GAGGAG---------	EEEDE	EE---
GTCTCAGACTCG	ATCTCA------	VSDS	IS--
TTGGGCAGG	TTGGAC---	MGR	LD-
TTCCACCAT	TTCCAC---	FHH	FH-
CCCGGGGGTGGCGGC	CCCGGG---------	PGGGG	PG---
GGCCCTCCG	GGCCCT---	GPP	GP-
TCCGACGAT	TCGGAC---	SDD	SD-
CAAAATGTGGCATCG	CAGAGT---------	QNVAS	QS---
TTTCAGTGA	TTTTAG---	FQ*	F*-
GATGAAGAG	GATGAA---	DEE	DE-
GCTGGAGGC	GCTGGA---	AGG	AG-
GGACCCAGGGGATCACCT	GGATCC------------	GPRGSP	GS----
GATGAGGAA	GATGAG---	DEE	DE-
CAGGAGGAA	CAGGAG---	QEE	QE-
ACAAATAAC	ACAAGT---	TNN	TS-
TTGGGAGGT	TTGGGA---	MGG	LG-
TCTCATCAC	TCTCAT---	SHH	SH-
AGCAAAAAG	AGCAAA---	SKK	SK-
TGGTTATTG	TGGTTA---	WLL	WL-
ACCTACAGT	ACCGAC---	TYS	TD-
GTTGCTTTTCAGGCC	CTCGCT---------	VAFQA	LA---
GCACCACCT	GCACCA---	APP	AP-
CCCGCCAGT	CCTCCC---	PAS	PP-
ACCCCACCT	ACCCCA---	TPP	TP-
CCCACCACT	CCCACC---	PTT	PT-
TCTGAGGAA	TCTGAG---	SEE	SE-
TCATCTCCTACGTCA	TCAACT---------	SSPTS	ST---
GCTTCTTCC	GCTTTT---	ASS	AF-
GTGCCTCCA	GTACCT---	VPP	VP-
GCCCAGTGA	GCTTAG---	AQ*	A*-
GAAATAAGTCCTTTC	GAAGGA---------	EISPF	EG---
CAGGAAGAG	CAGGAA---	QEE	QE-
ACGCCGCCA	ACGCCG---	TPP	TP-
CAAGGTGGA	CAAGGT---	QGG	QG-
GATCCCAGT	GATTCC---	DPS	DS-
TCTCTTCCACCTTTA	TCTCTT---------	SLPPL	SL---
AGCGCAGCG	AGCGCA---	SAA	SA-
GAAAGAAGG	GAGAGA---	ERR	ER-
AGTAGTGTTTCC	AGCAGT------	SSVS	SS--
CCCGGGGCCGGA	CCTGGG------	PGAG	PG--
GTTTCTTCA	GTTTCT---	VSS	VS-
GAGAGCTCA	GAGAGC---	ESS	ES-
GCAACAACT	GCAACA---	ATT	AT-
TCTTCAGACCACTCG	TCTTCA---------	SSDHS	SS---
AATGAAGAG	AATGAA---	NEE	NE-
AGCGATGACGATGAC	AGCGAT---------	SDDDD	SD---
ATAGGAGGG	ATAGGA---	IGG	IG-
GGCTCCAGT	GGAGCC---	GSS	GA-
ACAGCCAGCCCTCCAGCA	ACAGCC------------	TASPPA	TA----
GTTCCCCCG	GTTCCC---	VPP	VP-
GCAATTCGAGATTATGTC	GCTAGT------------	AIRDYV	AS----
GGCGGCGGCAGCGCG	GGCAGC---------	GGGSA	GS---
ACAGAGGAA	ACAGAG---	TEE	TE-
GTCGCCGCAGCCGCA	GTCGCC---------	VAAAA	VA---
AATGGTGGC	AATGGT---	NGG	NG-
GACATCGCT	GACAAC---	DIA	DN-
ATGAAGAAA	ATGAAG---	MKK	MK-
CCTTCCTCG	CCTTCC---	PSS	PS-
GACGCCGCG	GACGCC---	DAA	DA-
GTTCCTCAG	GTAGCT---	VPQ	VA-
AAGCGACGG	AAGCGA---	KRR	KR-
AAAGAACGGGAG	AAAGAA------	KERE	KE--
TGCAGCTCA	TGCAAC---	CSS	CN-
GGTGAGGAA	TGTGAG---	GEE	CE-
AAAGAGGAA	AAAGAG---	KEE	KE-
AAGGAAGAG	AAGGAA---	KEE	KE-
GGTAGAGAG	GGTACA---	GRE	GT-
GCCGGCGCAGGCACCGGT	GCCGAC------------	AGAGTG	AD----
GGGGATGAC	GGGGAT---	GDD	GD-
GGAGATGGG	GGGGCT---	GDG	GA-
GCACGATAG	GCATGA---	AR*	A*-
GGAGAGGAA	GGAGAG---	GEE	GE-
TCCTCTGGGTGCCACTCC	TCCTCT------------	SSGCHS	SS----
GCATCATCG	GCTTCA---	ASS	AS-
TCACCTCCTCCA	TCACCT------	SPPP	SP--
CCTGCTGGTGAAGTGGCC	CCTGCT------------	PAGEVA	PA----
GAGTCATCG	GAGTCA---	ESS	ES-
ACACCAAGG	ACACAA---	TPR	TQ-
AGTCCCGACCCT	AGTCCC------	SPDP	SP--
GAGGAGCTATGCCCGGAA	GAGGAG------------	EELCPE	EE----
TGGCTCAAGACCCTG	TGGCTC---------	WLKTL	WL---
CGCCCCAGTGGCAGT	CGCACC---------	RPSGS	RT---
ACGCCACCG	GCGCCA---	TPP	AP-
GAACTCCTG	GATTCC---	ELL	DS-
TACGCCGCG	TACGCC---	YAA	YA-
GGGTCATCG	GGGTCA---	GSS	GS-
AAGGCAGCG	AAGGCA---	KAA	KA-
GCAGAGGAA	GCAGAG---	AEE	AE-
CTAGGGGGT	CTAGGG---	LGG	LG-
CCGGAAGAG	CCGGAA---	PEE	PE-
CTGGCTGCC	CTGGCT---	MAA	LA-
CTGCCTGGGGATGAC	GTTACT---------	MPGDD	VT---
AGCTGCCAG	CACAGC---	SCQ	HS-
CACCATGATGAA	CACAGT------	HHDE	HS--
GTATCCTTATTGACG	GTGTAC---------	VSLLT	VY---
GCCAGCCCT	GCCAGC---	ASP	AS-
ACGCCCCCA	ACACCC---	TPP	TP-
GCCCCCAAG	GGTACC---	APK	GT-
CCGCTGCTA	CCCTTG---	PLL	PL-
CAGCCACCGCCG	CAGCCA------	QPPP	QP--
CCGCTGTTA	CCGCTG---	PLL	PL-
GTCCCACCCCCT	GTCCCA------	VPPP	VP--
ATTCCACCT	ATTCCA---	IPP	IP-
GGCACTGCTGCCACCACA	GGCACT------------	GTAATT	GT----
GAGCTTGAGGACCTC	GAGCTT---------	ELEDL	EL---
CAGTATCAC	CAGAAT---	QYH	QN-
GTTAATTATCCCAAC	GTTAAT---------	VNYPN	VN---
CCTCCCCAGCCA	CCACCC------	PPQP	PP--
GTATCATCT	GTATCA---	VSS	VS-
TTGGAGGAA	TTGGAG---	MEE	LE-
TCTCCAGAAGCAGAG	TCTTCA---------	SPEAE	SS---
AATGTTCTTGTA	AATGTT------	NVLV	NV--
CCCAACACG	CCCAGC---	PNT	PS-
GAAGGTGAGGCTGGG	GAAGGT---------	EGEAG	EG---
GACTCCCCGGGGTCT	GACTCC---------	DSPGS	DS---
GCCCCTCCG	GCCCCT---	APP	AP-
AAGCGCCGCCGT	AAGCGC------	KRRR	KR--
AAAGATTTTAAGAGAGAC	AATGAT------------	KDFKRD	ND----
AACAGCCCTCCAGCCAGT	AACAGC------------	NSPPAS	NS----
GGCTCACGCCCC	GGCTCA------	GSRP	GS--
TCCGGGGGA	TCTGGG---	SGG	SG-
GTTCGCATG	GTGTGC---	VRM	VC-
ATTGATGAC	ATGGAT---	IDD	MD-
CAGCAGGCCTCATGCCAA	CGGCAG------------	QQASCQ	RQ----
CAAACCACA	CAGACC---	QTT	QT-
CATAGAAGTAGG	CATAGA------	HRSR	HR--
GGGATGAGC	GATGAG---	GMS	DE-
CCAGCTCAGGCC	CCAGCT------	PAQA	PA--
ACTCCCGCG	ACTCAC---	TPA	TH-
GATCTTCTG	GAACTT---	DLL	EL-
TGTCACAGTCAT	TGTCAC------	CHSH	CH--
CTGGAAGAG	CTGGAA---	MEE	LE-
AGCGGCGGT	AGTGGC---	SGG	SG-
GAGTCTTCA	GAGTCT---	ESS	ES-
AAAGAAGAAGAAGAGGAG	AAAGAA------------	KEEEEE	KE----
AGCCCAAAG	AGCTCA---	SPK	SS-
ACGTCCTCT	ACGCCC---	TSS	TP-
GGAGCTGCTGCG	GGAGCT------	GAAA	GA--
GATGTAGCTGCTACT	GAGGGA---------	DVAAT	EG---
CACCAAGGCTCTAGG	CACAAA---------	HQGSR	HK---
GATGAAGAG	GACGAA---	DEE	DE-
GATCAGCTGTGA	GACTAG------	DQL*	D*--
GACGAGGAAGAAGAAGAA	GATGAG------------	DEEEEE	DE----
TCTCCATGT	TCTACA---	SPC	ST-
ATGGAGGAA	ATGGAG---	MEE	ME-
TTAGAAGAG	TTAGAA---	LEE	LE-
TCTGTGAGCAATGATCGT	GCCGAG------------	SVSNDR	AE----
TCAGCAGCG	TCAGCA---	SAA	SA-
AAGAACAAT	AAGAAC---	KNN	KN-
ATACCCCCT	GTGCCC---	IPP	VP-
GAAAAGGAA	GAAACG---	EKE	ET-
ACGCTCCTT	ACTCTC---	TLL	TL-
ATTTACTCT	ATTTAC---	IYS	IY-
GAAGGTGCA	GAAGTT---	EGA	EV-
GGCTTGTGT	GGCTCG---	GLC	GS-
AAGCATGAA	AAGCGT---	KHE	KR-
TGCCCTGTATTTGAG	TGCTCT---------	CPVFE	CS---
CAGTTAATATCCTTGCTC	CAGTTA------------	QLISLL	QL----
GTTGAAGAG	GTTGAA---	VEE	VE-
AGGCTGAGCCTC	AGGCTG------	RLSL	RL--
CTCGGTTCA	CTCAGT---	LGS	LS-
TTTGAAGAG	TTTGAA---	FEE	FE-
GAAGACGAT	GAAGAC---	EDD	ED-
GACGCCTCA	GACACC---	DAS	DT-
CTCCCCCCG	CTTCCC---	LPP	LP-
TTTCCTCCG	TTTCCT---	FPP	FP-
GGCTCGTCC	GGTTCG---	GSS	GS-
TCAAACAAT	TCAAAC---	SNN	SN-
CATTCAAGT	CATTCA---	HSS	HS-
TCAGAGGAA	TCAGAG---	SEE	SE-
GTGAGGACT	ATCGTG---	VRT	IV-
ACAGGAACT	AAGCAA---	TGT	KQ-
GAGGCAGCG	GAGGCA---	EAA	EA-
CTGCCTCCG	CTGCCT---	MPP	LP-
GCGGGAGCT	GCTGTA---	AGA	AV-
CGGGGTGGC	CGGGGT---	RGG	RG-
CGGGGTCCGGGA	CGGGGT------	RGPG	RG--
CCTGGGAACTCGACT	CCTGAG---------	PGNST	PE---
AGCTCGTGA	AGCTAG---	SS*	S*-
AAGTCTTCC	AAGTCT---	KSS	KS-
GACAGCAGT	GACAGC---	DSS	DS-
GATGTGGGTACC	GAAGGG------	DVGT	EG--
TCTCCAGCC	AGGCAA---	SPA	RQ-
TCTGAAGGTTGTGAG	TCTGAA---------	SEGCE	SE---
CCAGAACAAGAG	CCAGAA------	PEQE	PE--
GATGAGGACTGA	GAATAG------	DED*	E*--
TTCGAAGAG	TTCGAA---	FEE	FE-
ACAGGAGGG	ACGGGA---	TGG	TG-
GGGCCCCCG	GGACCC---	GPP	GP-
ACTCCTGCA	ACGTCT---	TPA	TS-
GGGCGCGTG	GCGTGC---	GRV	AC-
CCCTCCTCT	CCCTCC---	PSS	PS-
GACGAGGAC	GACGAG---	DED	DE-
CAGGAATGTGAGCTGGAG	CAGGAA------------	QECELE	QE----
TGCCTAAAG	TGCCCA---	CLK	CP-
CCTCTCATT	CCTGTC---	PLI	PV-
ACCGAGGAA	ACAGAG---	TEE	TE-
CACAATAAC	CACAAT---	HNN	HN-
AAGCACGGG	GCGCCC---	KHG	AP-
AGTGACGAT	AGTGAC---	SDD	SD-
CGACTGCTC	CGACTG---	RLL	RL-
AAACCACAGCCTGCACCC	AAGCCA------------	KPQPAP	KP----
GTGGCTTCTGTC	GTGACT------	VASV	VT--
GGAGGAACTGTTAGTGGC	GGAGGA------------	GGTVSG	GG----
AGAAGCTCA	CGAAGC---	RSS	RS-
CGCAGCGGCAGT	CGCAGC------	RSGS	RS--
GGTGTGAAC	GGTGGG---	GVN	GG-
GGCGGCGGCGGCGGCGGT	GGCGGC------------	GGGGGG	GG----
AACTTTTTA	AGAGCT---	NFL	RA-
CAGGAAGAG	CAGGAA---	QEE	QE-
GGAACCCCCGGG	GGAGCC------	GTPG	GA--
ATTGAAGAG	ATTGAA---	IEE	IE-
TCAGAAGAG	TCAGAA---	SEE	SE-
ACCTCTAGCAGTGGTAGC	ACCTCT------------	TSSSGS	TS----
GCAGAAGAG	ACAGAA---	AEE	TE-
GCCGACGACAACGAT	GCCGAC---------	ADDND	AD---
AGTGCAAAGGTGTCT	TCAACA---------	SAKVS	ST---
GAACCACCTCTTCCT	GAACCA---------	EPPLP	EP---
ACCTCATCT	ACCTCA---	TSS	TS-
TTGGGGGCC	ATAGAG---	MGA	IE-
CTGGATGAC	CTGGAT---	MDD	LD-
CAGGACTCAGCT	CAGGTC------	QDSA	QV--
ATCCTTCTC	ATCCTT---	ILL	IL-
CCTACAGGAGCC	CCTTCA------	PTGA	PS--
CCTCAACAG	CCTCAA---	PQQ	PQ-
GCCAGCCAGAGGACA	GCAGTC---------	ASQRT	AV---
GCAACCACA	GCAACC---	ATT	AT-
AACGCAGCG	AACGCA---	NAA	NA-
AGAGAGGAA	AGAGAG---	REE	RE-
CCCGGGGGC	CCCGGG---	PGG	PG-
ACCCAGCAGAGA	AGCAAG------	TQQR	SK--
CTGCCTGAGCCC	CTGCCT------	MPEP	LP--
CAGCTGGAA	CAGAGG---	QLE	QR-
AGGGACTAT	AGGGCC---	RDY	RA-
CAAGGAGGG	CAAGGA---	QGG	QG-
CTGCCCCCG	CTGCCC---	MPP	LP-
GCAAGACACAGT	GCAACA------	ARHS	AT--
CCTATTGCA	CCTCAT---	PIA	PH-
GGTAGAAGG	GGTAGA---	GRR	GR-
CCCTCTAGAGCCCCC	CCCATT---------	PSRAP	PI---
TATCCTCCC	TATCCT---	YPP	YP-
GACGGCACA	GAGAGC---	DGT	ES-
TGGGAGGACGAA	TGGGAG------	WEDE	WE--
GATAAGAAA	GATAAG---	DKK	DK-
CTGCATCAGCAC	CTACAT------	MHQH	LH--
TTGGCCCCAGATGCT	TTGGCC---------	MAPDA	LA---
AAACCTTTTTCTCCC	AAAATT---------	KPFSP	KI---
AGCGCAGCT	AGCACA---	SAA	ST-
CAGGCTGCG	CAGGAT---	QAA	QD-
GAGTCTGGATTCTGGTCA	GAGTCT------------	ESGFWS	ES----
GCTGGGGGC	GCTGGG---	AGG	AG-
GGCCGTCAGGACTCA	GGCAGT---------	GRQDS	GS---
GCCTCCTCT	GCCTCC---	ASS	AS-
GCTCCACGCCCTCGCCCC	GCTCCA------------	APRPRP	AP----
ACCTCTTCC	ACCTCT---	TSS	TS-
GATGGTGGA	GACAGT---	DGG	DS-
AATGAACAGTAC	ACTGTA------	NEQY	TV--
ATGTCCAGT	GTGTCC---	MSS	VS-
TCTGGGCCC	GCTGTG---	SGP	AV-
CAGCCACCC	CAGCCA---	QPP	QP-
AACTCCTCT	AACTCC---	NSS	NS-
CCGGAAGAG	CCGGAA---	PEE	PE-
CCAGGATCAGGG	CCAGGA------	PGSG	PG--
GATCTTCTG	GATCTT---	DLL	DL-
GACTACCAG	GGGTCC---	DYQ	GS-
CCTTCATCT	CCTTCA---	PSS	PS-
CAGGAAGAG	CAGGAA---	QEE	QE-
TGGGAGCCAGAGCCTTGA	TGGTAG------------	WEPEP*	W*----
CTGGGGGGT	CTGGGG---	MGG	LG-
GTGGAGGAA	GTGGAG---	VEE	VE-
AGCCTGCTGCTC	AGCCTG------	SLLL	SL--
AAACTGAGC	AAGCAG---	KLS	KQ-
CTGAGAAGG	CTGAGA---	MRR	LR-
GAGCTGCCC	GCGGAG---	ELP	AE-
ACAGAGGCTCTAGAAGAA	GCAGAG------------	TEALEE	AE----
AACCACCAT	AACCAC---	NHH	NH-
TCTGAGGCATATGAA	TCTGAG---------	SEAYE	SE---
CTTCAGCGCTGA	CTTTAG------	LQR*	L*--
GGTGATGAC	GCCGAT---	GDD	AD-
TTTCCAGAAACCGGGCCG	TTTCCA------------	FPETGP	FP----
GCTTCAAGT	GCCTCA---	ASS	AS-
CTTAGCAGT	CTTAGC---	LSS	LS-
GCAGTCAAG	GCGGGC---	AVK	AG-
AAAGTCTGCGTT	GAAGTC------	KVCV	EV--
TTGTTCAGGTTT	TTATTC------	MFRF	LF--
TTCTCCAGT	TTCTCC---	FSS	FS-
TCAGAGGAA	ACAGAG---	SEE	TE-
TATGAAGAG	CATGAA---	YEE	HE-
GACCTTTTG	GACCTT---	DLL	DL-
AGTGGTGCA	AGCTGT---	SGA	SC-
AGATCTGGATCA	AGGTCT------	RSGS	RS--
CCAGATGAC	CTGGAT---	PDD	LD-
ACAACTCCAGGA	TCAGCT------	TTPG	SA--
TCTGGCATGGGT	TCTGGC------	SGMG	SG--
AACCAAAAG	AACCGA---	NQK	NR-
GGGGAAGAG	GGGGGA---	GEE	GG-
CGCTCCTCA	CGCTCC---	RSS	RS-
GCAGTTATGACA	GCAGAT------	AVMT	AD--
GAGGGAGGCCTGTCCTCT	CAAGAA------------	EGGLSS	QE----
CAGCCTGAGCCTGAGCCA	CAACCT------------	QPEPEP	QP----
CAGCCTCCA	CAGCCT---	QPP	QP-
CCTACAACC	CCCACA---	PTT	PT-
CTCAGCAGT	CTCAGC---	LSS	LS-
GAAGGAGGC	GAGGGA---	EGG	EG-
AGTACCTCGTGGACA	AATACC---------	STSWT	NT---
GAGCCTCCGCCGCCC	GAACCT---------	EPPPP	EP---
CCCGTGGTC	CCCATG---	PVV	PM-
GGCAAGAAA	GGCAAG---	GKK	GK-
GCAAATGACTCC	GCAAGT------	ANDS	AS--
GCGCCGATGCCA	CCACCG------	APMP	PP--
GCTTTGTTGCTA	GCTGTG------	ALLL	AV--
GGGATGTCC	GGCAAG---	GMS	GK-
GAGGACAGATGTCCT	ATGGTC---------	EDRCP	MV---
GCCGGAGGT	GCCAGA---	AGG	AR-
GGCAGCTCA	GGCAGC---	GSS	GS-
TCCTGGTCT	CACAGG---	SWS	HR-
AGTGGAGGC	AGTGGA---	SGG	SG-
ATGAGTAGCAGC	ATGAGT------	MSSS	MS--
CCACTGAGA	GAGCAG---	PLR	EQ-
CCAGCAGCT	CCAGCA---	PAA	PA-
GAGCTCCTG	GAGCTC---	ELL	EL-
AGTGAGAAA	AGTGGG---	SEK	SG-
CCAGGTGCA	CCACGT---	PGA	PR-
TTCTGGACCAGC	CTGCAG------	FWTS	LQ--
AGTGAGGAA	AGTGAG---	SEE	SE-
GCACCCTCTCTACCT	GCACCC---------	APSLP	AP---
AGTGAGGAGGAA	AGTGAG------	SEEE	SE--
AGCGGGGGA	AGCGGG---	SGG	SG-
CCGAGGAGA	CCGAGG---	PRR	PR-
GTGGGCGGTGGT	GTGGGC------	VGGG	VG--
TTCCTGACTCCACTGGGC	TTCCAG------------	FLTPLG	FQ----
GAGGCCACA	GAGGTC---	EAT	EV-
CTTGGGGGTGGCGGC	CTTGGG---------	LGGGG	LG---
TTGCTGCGTGCC	GTAAAG------	MLRA	VK--
AGACCCCCT	AGACCC---	RPP	RP-
CACCAGTGCCAA	CACTCG------	HQCQ	HS--
CTGCCAAAGCCTCAG	CTGCTA---------	MPKPQ	LL---
ATTGGTGAG	CTCAGT---	IGE	LS-
CCCCGCTAT	CCTCTC---	PRY	PL-
GCACGACGT	GCACGA---	ARR	AR-
GCCTACGTG	GCCTGC---	AYV	AC-
GAAGCGGCC	GAAGCG---	EAA	EA-
AACAGAGTT	AGCACA---	NRV	ST-
TGGCTGCTGGAGAAGGCC	TGGCAG------------	WLLEKA	WQ----
TCTGAGGAA	TCTGAG---	SEE	SE-
GGTAGTAGC	GGTAGT---	GSS	GS-
TCAGGTGGC	TCCGGT---	SGG	SG-
GCCCGTGGA	GCCTGT---	ARG	AC-
GAATCGGCCTCA	GAATCG------	ESAS	ES--
GAGTCATCT	GAGTCA---	ESS	ES-
CAAGTTGTA	CAAGTT---	QVV	QV-
GGGGGAACAGAG	GGGACA------	GGTE	GT--
AGAGCTGCA	AGAGCT---	RAA	RA-
GGCACCGCT	GGCAGC---	GTA	GS-
CCGCTGCTA	CCACTG---	PLL	PL-
AGCCACCAT	AGCCAC---	SHH	SH-
GAGCCCCAGCCT	GAGCCC------	EPQP	EP--
CAGTCTGAGTCC	CAGCCT------	QSES	QP--
AGCGGCGGA	AGCGGC---	SGG	SG-
ATAGAAAGACAGCAAGAG	ATAGAA------------	IERQQE	IE----
ACAGCCTCTGCT	ACAGCC------	TASA	TA--
TTGGTCAAGGATGTT	TTGGCC---------	MVKDV	LA---
TGTCACCAA	TGTCGC---	CHQ	CR-
CTGCAGCAGCAACAGCAA	CTGCAG------------	MQQQQQ	LQ----
CCCAGCCATCAA	CCCATC------	PSHQ	PI--
ACCTGGGCACAGTGA	ACCTAG---------	TWAQ*	T*---
ACAGAAGAG	ACAGAA---	TEE	TE-
AGGGCAGGGGCG	AGGGCA------	RAGA	RA--
CGCCAGTGA	CGCTAG---	RQ*	R*-
AAGAAAGACAAG	AAGAAA------	KKDK	KK--
AAGGGAGCACAT	AAGAGA------	KGAH	KR--
CATAGTTCA	CACAGT---	HSS	HS-
TTGAGTTTGGAAGACCAC	TTTTTT------------	MSLEDH	FF----
CACTGGACAGAGTCA	CACCAG---------	HWTES	HQ---
AACTCTACTTCC	AACTCT------	NSTS	NS--
TGTTTGCTT	TGTTTG---	CLL	CL-
GATGAAGAG	GATGAA---	DEE	DE-
CAGACGACA	CAGACG---	QTT	QT-
GAGACTTCC	GAGAAT---	ETS	EN-
TCTGGCAAG	TCTAGC---	SGK	SS-
TCCGGCACCACAGTCCAG	TCCAGC------------	SGTTVQ	SS----
AGCGAGGAGGAGGAA	AGTGAG---------	SEEEE	SE---
AGGGGAGGC	AGGGGA---	RGG	RG-
AGACATTTC	AGATAT---	RHF	RY-
GCTGTGGTC	GCTGTG---	AVV	AV-
GGCTGTTCC	GGCGGT---	GCS	GG-
ACTCAGTGA	ATTTAG---	TQ*	I*-
CTGGAGGAA	CTGGAG---	MEE	LE-
CTGGCCGTTGCT	TTGGTC------	MAVA	LV--
AAGCCTGTGCCA	AAGCCT------	KPVP	KP--
GCTTCTTCC	GTCTCT---	ASS	VS-
CAGACCTCT	CAGCCC---	QTS	QP-
GAGTCTTCA	GAGTCT---	ESS	ES-
TTTGGAGGT	TTTGGA---	FGG	FG-
GTACAGTCACCACCCTGA	GTATAG------------	VQSPP*	V*----
GCACCCACT	GCATCC---	APT	AS-
AAGGGGGGT	AAAGGG---	KGG	KG-
GAGGGAGGT	GAGGGA---	EGG	EG-
TTGTATCCTTTTAAC	TTGGGT---------	MYPFN	LG---
GAGTGGACA	GAGAGG---	EWT	ER-
CATGGAGGC	CATGGA---	HGG	HG-
GTGACGTCACCTCAA	TTGATG---------	VTSPQ	LM---
GATGAGGAA	GACGAG---	DEE	DE-
TTGAAAAAG	TTGACA---	MKK	LT-
GTGCCGCCA	GTGCCG---	VPP	VP-
AGTGAAGAAGACGAG	AGTGAA---------	SEEDE	SE---
AAGCTCATA	AAGCCC---	KLI	KP-
ATGCCCACA	GTGCAC---	MPT	VH-
ACTGCTGATTTAGCC	ACTGCT---------	TADLA	TA---
GAGGAAGAAGGAGAG	GAGGAA---------	EEEGE	EE---
ATAGCTGCA	ATAGCT---	IAA	IA-
AGAGGTAAAGAC	AGAAGT------	RGKD	RS--
ACTGCTGCCGCTGCC	ACTGCT---------	TAAAA	TA---
TCGGAAGAGGAGGAG	TCGGAA---------	SEEEE	SE---
GAAAAGAAA	GAAAAG---	EKK	EK-
GCTTTGTGA	GCTTAG---	AL*	A*-
AACCCCAAA	ACCCGC---	NPK	TR-
GTGCGACGG	GTCCGA---	VRR	VR-
GAAGGAGAT	AAGAGA---	EGD	KR-
AGATCCTCT	AGATCC---	RSS	RS-
AGTGGCGGCGGCGGT	AGTGGC---------	SGGGG	SG---
CAAGGAACT	CAAGAA---	QGT	QE-
CATGTCAGT	CATGCC---	HVS	HA-
AGCGGCGGA	AGCGGC---	SGG	SG-
TACGGGGGC	TACGGG---	YGG	YG-
GAGCAGTGTCAA	GAGCAG------	EQCQ	EQ--
AAGACTACA	AAGACT---	KTT	KT-
GACGGTGAC	GAGAGT---	DGD	ES-
AGTAACCAGTGCAAT	AATAAC---------	SNQCN	NN---
TCCTGGAGGTGA	TCCTAG------	SWR*	S*--
GACGAGGAA	GATGAG---	DEE	DE-
ATTTCTAAA	ATTCTT---	ISK	IL-
GTTTCTTCC	GTTTCT---	VSS	VS-
GATGAAGAT	GACGGA---	DED	DG-
AAACGTGTG	AAATGT---	KRV	KC-
AATACCACT	AATAGC---	NTT	NS-
CCAGAGCTACTGGAA	CCAGAG---------	PELLE	PE---
CCTGCTGCCGCC	CCTGCT------	PAAA	PA--
GCCCTCCTT	GCCCTC---	ALL	AL-
GATGGTGGC	GATGGT---	DGG	DG-
CAGCCGAGATCA	CAGCAG------	QPRS	QQ--
AGAATTGATTTTGGG	AAGAAT---------	RIDFG	KN---
CTATTTTTC	GTATTT---	LFF	VF-
GCTTTTGAG	TCTTCT---	AFE	SS-
GCAGCTGCCACCGCC	GCAGCT---------	AAATA	AA---
GATGAGGAA	GATGAG---	DEE	DE-
TACCCGCCC	TATCCG---	YPP	YP-
GAGAAAACAGAGACT	GAGGAA---------	EKTET	EE---
GACAGAACCAGG	GACAGA------	DRTR	DR--
AAAGATGCA	AAACAT---	KDA	KH-
GTGCAGCCTGTCTGA	GTGTAG---------	VQPV*	V*---
TTCAGTAGC	TTCAGT---	FSS	FS-
CTTCCAAGG	TTCCAA---	LPR	FQ-
CCCACAACAACC	CCCACA------	PTTT	PT--
TCGCCTCCC	TCGCCT---	SPP	SP-
GAGGAGGAGAAGGAA	GAGGAG---------	EEEKE	EE---
CCTCAGCAACAA	CCTCAG------	PQQQ	PQ--
ACTGTTGTG	ACTGTT---	TVV	TV-
CCTGCTGCA	CCTGCT---	PAA	PA-
GACTGGACA	GATGGG---	DWT	DG-
CACAGCAGT	CACAGC---	HSS	HS-
GCCGGCGGCGGCGGG	GCCGGC---------	AGGGG	AG---
GTCAGGCTCGACGACCGT	GTCAGG------------	VRLDDR	VR----
GAAAATAAAGCAAAC	GAAAAT---------	ENKAN	EN---
GCACGGCGC	GCACGG---	ARR	AR-
AAAGGTGGA	AAAGGT---	KGG	KG-
GACATCAAA	GAGTCC---	DIK	ES-
TCGCCTGGA	TCTCAT---	SPG	SH-
TCTTTTCCATTCAAC	CCGTCT---------	SFPFN	PS---
ACAGAAGAG	ACAGAA---	TEE	TE-
CCCACACTGGCTGCCTCT	CCTCCA------------	PTLAAS	PP----
ACTTCTTCTTCCTCC	ACTTCT---------	TSSSS	TS---
GAGACAACG	GAGACA---	ETT	ET-
CTCAATAAC	CTCAAT---	LNN	LN-
GGGGTTGTC	GGGGTT---	GVV	GV-
GTGACAACC	GTGACA---	VTT	VT-
TCTCCATTGTGT	TCTTCA------	SPLC	SS--
TTGACAAAGACT	CTGCCA------	MTKT	LP--
TCTGCTGCC	TCTGCT---	SAA	SA-
AAAGTTGTG	AAAGTT---	KVV	KV-
GCACCCCCG	GCACCC---	APP	AP-
AAGGTGCAGCCAGTA	AAGGTG---------	KVQPV	KV---
GGTGATCAG	GGTAGT---	GDQ	GS-
AAGCCGAAT	AAAGTG---	KPN	KV-
GACAGCAGT	GACAGC---	DSS	DS-
GCTGTGGTCAAAGTA	GCTCTG---------	AVVKV	AL---
GCGGGAGAG	GCGAGA---	AGE	AR-
ATCAATAAC	ATCAAT---	INN	IN-
GACAAAGAAAAG	GACAAA------	DKEK	DK--
CAAGATACTGAC	CAAGAT------	QDTD	QD--
ACTCATATCCAG	ACTCCT------	THIQ	TP--
ACTTCATGGGAGGCCTCC	ACTTCA------------	TSWEAS	TS----
CTAGAAGAG	CTAGAA---	LEE	LE-
CTGCCGCCACCT	CTGCCG------	MPPP	LP--
GAGGCAGCT	GAGGTA---	EAA	EV-
TGCTTGCTT	TGCTTG---	CLL	CL-
ATAGAGTGA	ATATAG---	IE*	I*-
ACACCACCCCCG	ACACCA------	TPPP	TP--
ATGAAAAAG	ATGAAA---	MKK	MK-
GACAGCAGT	AACAGC---	DSS	NS-
TCCGCAGCAGCGGCAGCG	TCCGCA------------	SAAAAA	SA----
TATAAACCCAAG	TATAAA------	YKPK	YK--
GCGCCACCGCCG	GCGCCA------	APPP	AP--
ATGGGTGGCGTGGGA	ATGGGT---------	MGGVG	MG---
TTCAATCCCGAGTAC	CTCCAT---------	FNPEY	LH---
AAAGCCCAGACTGCT	GAAGCC---------	KAQTA	EA---
ACCCCAGTTCCTGAGCCT	ACCCCA------------	TPVPEP	TP----
TGGGAGGAA	TGGGAG---	WEE	WE-
CTAGATACTGAGGTGGAC	CTAGAT------------	LDTEVD	LD----
GCGGTACAT	AAGACA---	AVH	KT-
AGAGGTGGA	AGAGGT---	RGG	RG-
AACGGAGGC	AACGGA---	NGG	NG-
AATGAAGAG	CATGAA---	NEE	HE-
ACTGCTGCC	ACTGCT---	TAA	TA-
ATTCCTGTAACCCCA	ATTCCT---------	IPVTP	IP---
AAGGGCTCT	AAGGTC---	KGS	KV-
GCCGGAGGC	GCCGGA---	AGG	AG-
GAGCTTGAA	GAACCT---	ELE	EP-
CCCGCGGCC	CCCGCG---	PAA	PA-
GCAAGGAGAGACAGA	GCACAG---------	ARRDR	AQ---
GCTCCTGTCCCGGTCCCG	GCTGCT------------	APVPVP	AA----
AAAATCATT	AAAAAC---	KII	KN-
CATTTCCCATTT	CACTCC------	HFPF	HS--
GGCGAAGAG	GCTGAA---	GEE	AE-
GCCCCACCC	GCTCCA---	APP	AP-
CAGCCCAGT	CAGTCC---	QPS	QS-
GCGCAGCAA	GCACAG---	AQQ	AQ-
AGCAAAAAG	AGCAAA---	SKK	SK-
GAGAAGAAA	GAGAAG---	EKK	EK-
TCAGCACCAGCC	TCAGCA------	SAPA	SA--
CAGGAGGAA	CAGGAG---	QEE	QE-
ATGGCTGCC	ATGGCT---	MAA	MA-
AAGACGACT	AAGACG---	KTT	KT-
AATCTTCTCAGCGAGAGA	AATCAT------------	NLLSER	NH----
AGGACATCT	AGGCCA---	RTS	RP-
CCCCCTCCCCCCTTGCCA	CCACCT------------	PPPPLP	PP----
GACGAGGAA	GACGAG---	DEE	DE-
GTGCGGTAC	GTAATG---	VRY	VM-
GTAAAAAAG	ATAAAA---	VKK	IK-
TCAACGACCAGT	TCAGCG------	STTS	SA--
TGTTATCCA	TGTTGT---	CYP	CC-
ATACTGCTT	GTACTG---	ILL	VL-
GGGGAAGAG	GGGGAA---	GEE	GE-
GGAGAGCTGGAA	GGAGAG------	GELE	GE--
CTGCCTTCA	CTGACT---	MPS	LT-
GATAGTAGCAGC	GATAGT------	DSSS	DS--
TCAGTGGGTGGC	TCGCAG------	SVGG	SQ--
GGAGATGGA	GGCGCT---	GDG	GA-
GGTAAGAGT	GGAGTG---	GKS	GV-
AAGAAGCTGGGGAAA	CTTAAG---------	KKLGK	LK---
ACCTCCTCT	ACCTCC---	TSS	TS-
TGCCCACCT	TGCCCA---	CPP	CP-
TGGAGGCGT	TGGAGG---	WRR	WR-
CTCCAGCTGTGA	CTCTAG------	LQL*	L*--
GACGGCGGA	GACGGC---	DGG	DG-
CAGGAGGAA	CAAGAG---	QEE	QE-
CTGTGCAAG	CTGAGC---	MCK	LS-
GATGAGTCATGTTGA	GATTAG---------	DESC*	D*---
CGGGCGGCT	CGGGCG---	RAA	RA-
GAATGTAAA	GAAAGT---	ECK	ES-
GCTCCCCCA	GCTCCC---	APP	AP-
GATGAGTCTGAACACTGA	GATTAG------------	DESEH*	D*----
CATCCATGTCAGAGTTGC	CATGCA------------	HPCQSC	HA----
GAAGGAGGC	GAAGGA---	EGG	EG-
GAAGATGAC	GAGGAT---	EDD	ED-
CACCCTCCG	CACCCT---	HPP	HP-
TTGGCTGCA	TTGGCT---	MAA	LA-
GTGACTAGC	GTGCCT---	VTS	VP-
ACCGCCGCT	ACCGCC---	TAA	TA-
TCGCCCCCG	TCACCC---	SPP	SP-
GTGGCTGCGGCA	GTGGCT------	VAAA	VA--
CCCCCACCC	CCCCCA---	PPP	PP-
CCTTCATCC	CCTGCA---	PSS	PA-
CCTGCATCC	CCTGGA---	PAS	PG-
AAAGACAAG	AAACAC---	KDK	KH-
CTTCAACAG	CTTCAA---	LQQ	LQ-
