wid.1	wid.2	amino_acid.1	amino_acid.2
ACGGAGCAG	---GGGCAG	TEQ	-GQ
GGCCTCTAG	---CACTAG	GL*	-H*
GCAGGCCGGCTGCCG	---------CACCAG	AGRLP	---HQ
TCCACCAGC	---AGAGAC	STS	-RD
GAGCCTCTTGAC	------CCTGAC	EPLD	--PD
TCAGAGAGTATG	------AAGTTC	SESM	--KF
AGCATTGGTGAG	------GTTGAA	SIGE	--VE
CCTGGGCCC	---GTGCCC	PGP	-VP
GCTAAGGAG	---AGCGAG	AKE	-SE
GCCCCCTGT	---CCCTCT	APC	-PS
CAGCTCGTCAGAAAA	---------ACAGAG	QLVRK	---TE
GCCGCGGCCCCGGCG	---------CCTTCC	AAAPA	---PS
CTGGACACG	---GCCGCG	MDT	-AA
AAGAAGTTATATCAA	---------TCTCAA	KKLYQ	---SQ
AAGGACTAA	---GCCTAA	KD*	-A*
GAGCTGTTTGAC	------TCTTCC	ELFD	--SS
GCCAATAGT	---AGTAGT	ANS	-SS
CAGTCTGTTGGTACA	---------GTTACA	QSVGT	---VT
GCGTCATCATACTTGGCT	------------TGCGTT	ASSYLA	----CV
GACTCCTTGCTG	------TCACTG	DSLL	--SL
AAGGATGAG	---GCTGAG	KDE	-AE
ACACGGGGC	---CTGGGA	TRG	-LG
AGCTACCCGTTT	------CAGTTT	SYPF	--QF
GAGTGCAGG	---TCCAGG	ECR	-SR
AGCTATGGC	---TCTGGC	SYG	-SG
GGCTTCCGC	---TCTCGG	GFR	-SR
AGCGGTGGCTCA	------GTCTCA	SGGS	--VS
GCGCATCAGAACGGC	---------AGTGGC	AHQNG	---SG
ATGTTGCTG	---TTGCTG	MLL	-LL
TCCATCCTGGCA	------CATCGT	SILA	--HR
TCTGGTATA	---GATATA	SGI	-DI
AGTTGCCTGCTT	------CAGGAA	SCLL	--QE
AGTCCTGGCGCT	------GCGTCT	SPGA	--AS
CCGGACTCGACG	------TCGACG	PDST	--ST
GCTCCCTGCTCT	------TTCAGT	APCS	--FS
AGATGTGCT	---TATGCT	RCA	-YA
AAAGAAGAA	---GGAGAA	KEE	-GE
AGCTGCAAG	---TACAAG	SCK	-YK
TCTCCAGAGGAA	------GGAGAA	SPEE	--GE
AGTCTTCGA	---CCTCGA	SLR	-PR
GCGACGCCC	---ACCCCA	ATP	-TP
AGCATCTCCCTGTGTACC	------------TCAACA	SISLCT	----ST
ACCGTCGTGCAG	------GGACAG	TVVQ	--GQ
AAGGAGGAACATTTT	---------CGTTTT	KEEHF	---RF
GCCCAGAAGCTCCTGAAG	------------CAGAAG	AQKLLK	----QK
ACCCCACCA	---CTACCA	TPP	-LP
TCAGAAGTAGCA	------GGAATA	SEVA	--GI
GTCTCTGCCATGGAG	---------ACAGAG	VSAME	---TE
CAGGTAAAC	---GGAAAC	QVN	-GN
GCACACGCTTCGCCAAGG	------------CAGAGG	AHASPR	----QR
AGCTTCCCA	---TCCCCA	SFP	-SP
CATATGGGGATGAAC	---------ATGAAC	HMGMN	---MN
CTGTTTGTT	---TGTGTC	MFV	-CV
AAGCCACTGATG	------CCAATG	KPLM	--PM
AGCCTGGTA	---CCTGTA	SLV	-PV
GACATCCAG	---AGCCAG	DIQ	-SQ
ACAGGCTGC	---GTCTGC	TGC	-VC
TCAGACAAGAAGCTC	---------AACATA	SDKKL	---NI
GGCAGCCTGCCC	------CATCCA	GSLP	--HP
GTGCGAAACAGAGGT	---------ACAGGT	VRNRG	---TG
ACACCTCCA	---CTTCCA	TPP	-LP
AGAGTGCTG	---GAGTAT	RVL	-EY
TATAAATTC	---ATATTC	YKF	-IF
GCAAGAAGA	---ATGAGA	ARR	-MR
GAGGAGCTCGGC	------CCCTCC	EELG	--PS
AGTGGTGGTGGC	------GACAGC	SGGG	--DS
ACCGCCTTG	---GACCTC	TAL	-DL
ACGGGCTGCGGG	------TTCGGG	TGCG	--FG
ATGTTCTCT	---TGTTCT	MFS	-CS
GAGAGCTGC	---AGATGC	ESC	-RC
AAACACACCCGCCAG	---------CCTCGG	KHTRQ	---PR
AGGACACTGGCG	------CCTGCC	RTLA	--PA
GCAAACACG	---AGCACG	ANT	-ST
CGAAGTCTA	---AGGCTG	RSL	-RL
ACACGCCTT	---CTCCTC	TRL	-LL
GAAATACCT	---AGGGGT	EIP	-RG
CTCTGTGGC	---TATGGC	LCG	-YG
GCGCCACTGCAG	------CAGCAG	APLQ	--QQ
GACCTCCCA	---CCTCCC	DLP	-PP
AACCTGAAG	---CCTAAG	NLK	-PK
TCAGGAGAG	---GAAGAG	SGE	-EE
CTCGGGGTGGGCGGG	---------GAACCG	LGVGG	---EP
TCCTTGGAGAAA	------GGGAAG	SLEK	--GK
TGTGGCGGA	---GTGGAG	CGG	-VE
CTTGGTGGACACTTGTCT	------------TTGTGG	LGGHLS	----LW
TCAAATGAA	---AGTGAG	SNE	-SE
TCTGTGGCA	---GGGCCA	SVA	-GP
TGGCTTCATGTG	------CTAGCC	WLHV	--LA
AAAAACACACTTGGG	---------CCTGGC	KNTLG	---PG
AGCAGGCTGGAT	------CCAGAT	SRLD	--PD
ATGCTGAAG	---CTGGAG	MLK	-LE
TCAATGGGA	---AGTGGA	SMG	-SG
AAGGTCCCG	---GGCCTG	KVP	-GL
AGTCATGCC	---CCCACC	SHA	-PT
GCAGCGTCCAACTCC	---------AGTTCC	AASNS	---SS
GCGAACACT	---AGCACC	ANT	-ST
CATGTTGTG	---GGAGCC	HVV	-GA
ACTGAAGAATGCTCGTGA	------------TACTGA	TEECS*	----Y*
TCTGGCAGG	---GACAGG	SGR	-DR
AGGTCACTAGGC	------CAAGGT	RSLG	--QG
CCAGTGGAA	---GAGGAA	PVE	-EE
AGTACCACTACACGAGTA	------------CAAGTA	STTTRV	----QV
TCTGGGGAC	---GAGGAC	SGD	-ED
AGCGTGAGA	---GCAAGA	SVR	-AR
AAGGAGAAA	---GGGAAA	KEK	-GK
GGTCTACCA	---CCACCA	GLP	-PP
GGCAGCAGC	---AGCAGC	GSS	-SS
TCGCCGCCGCCG	------CGCCCG	SPPP	--RP
GAAAGAGAA	---ACAGAA	ERE	-TE
TCTGATCAC	---GGTCAC	SDH	-GH
GAGCTACTG	---CCACTA	ELL	-PL
AAACCATTT	---CGATTG	KPF	-RL
GAACTGAAA	---CCTGAC	ELK	-PD
GAAATAGAT	---AGAGAT	EID	-RD
GCATGCAAT	---TACAGT	ACN	-YS
TCTGGGATG	---GAGGTG	SGM	-EV
AAAACTGAGGCA	------GGGGCA	KTEA	--GA
GCTTTTCCA	---TGCCCT	AFP	-CP
GTTTTTAGG	---TCTCGG	VFR	-SR
CAGAAACACAGGGAG	---------AGTGAG	QKHRE	---SE
ACAGCAGGGAGAGAAAAC	------------GTGAAA	TAGREN	----VK
ACTGAGTGT	---GTGTGT	TEC	-VC
AGTTTTGGTGGAGGT	---------GCCGGC	SFGGG	---AG
TCTGGCTGCCCCCTGGCG	------------CAGCAT	SGCPLA	----QH
TCTGCCAGC	---GACAGC	SAS	-DS
AATGTGGAC	---GCAGCC	NVD	-AA
ACACCACCT	---CTGCTT	TPP	-LL
GAAGTTAGGTTTCCT	---------TCTCCC	EVRFP	---SP
ATGCCAGCA	---CAATCA	MPA	-QS
ACTGTTCGC	---GAGCGG	TVR	-ER
GCCCCGGCT	---CAGGCT	APA	-QA
TCCGGCAACTGC	------AGCTGC	SGNC	--SC
ACGGAAAAA	---GTCTGC	TEK	-VC
TCTGGTGGAGTAGGC	---------GACCAG	SGGVG	---DQ
GCTCCGCCTCCGCCG	---------CACCCC	APPPP	---HP
CGTGGGGGT	---GTGGGG	RGG	-VG
CGAGGGGGT	---GAGGGT	RGG	-EG
AAGGAAATCCACCCAACG	------------CGCCTG	KEIHPT	----RL
TCAACTGGCTTC	------GATTTC	STGF	--DF
CTGGCCTTAGCT	------TTAGCT	MALA	--LA
ACGCAGGAGCACTCGGAC	------------TTGAGC	TQEHSD	----LS
GCCCTGCCAGGT	------CTAGGT	ALPG	--LG
TCCGTGCGA	---GAGCCA	SVR	-EP
GCTCACCAC	---CTCCCA	AHH	-LP
