wid.1	wid.2	amino_acid.1	amino_acid.2
AAGAGTAGC	AAA---AGT	KSS	K-S
GGACCTGGG	GGG---TCT	GPG	G-S
AGTTCACGGGCG	AGT------CCA	SSRA	S--P
TCAACACCCACTCCAACT	TCA------------ATA	STPTPT	S----I
GTGGGTCCGGGC	GTG------GGT	VGPG	V--G
GAAGGCCAAGGT	GAA------GGC	EGQG	E--G
GTTGGTGTC	GCA---CCT	VGV	A-P
TCAGAGCCTGAA	TCG------GAG	SEPE	S--E
CGGCTGCTA	CGG---CCG	RLL	R-P
ATGGGGTCACCT	CTG------GAG	MGSP	L--E
ACTGCGGCA	ACA---GCG	TAA	T-A
GGCCTCCTG	GGA---CTC	GLL	G-L
CCCAGAGGAGAGAGG	CCC---------AGA	PRGER	P---R
GATTTTAGA	GAG---TCT	DFR	E-S
TATTCTTCCTCTTCTTCC	TAT------------TCT	YSSSSS	Y----S
CCTGTTGTG	CCT---GTT	PVV	P-V
TCTCAGCAA	TCT---CAG	SQQ	S-Q
TCTCTTGGGGGC	AAC------ACT	SLGG	N--T
GATCCTAAGAAA	GAT------CTT	DPKK	D--L
GAAAATGCA	GAA---AGT	ENA	E-S
CTGTCATCG	CTT---TCA	MSS	L-S
TTCTGGTGA	GTC---TAG	FW*	V-*
TCAGGTGGC	TCA---GGT	SGG	S-G
ACCATCGCACAG	ACC------ACC	TIAQ	T--T
GAGCCTGTGGTGCCC	GAG---------CCT	EPVVP	E---P
CACATTGCGTCA	TAC------AGT	HIAS	Y--S
GATGGACTC	GAT---AGA	DGL	D-R
CTGGAGGAA	CTG---GAG	MEE	L-E
GACGAGGAA	GAC---GAG	DEE	D-E
ATCGTAAAC	ATG---TCA	IVN	M-S
CAGGCGGCA	CAG---GCG	QAA	Q-A
GGCGTGCTT	GGT---TGG	GVL	G-W
CAGGGTGGCGGC	CAG------GGT	QGGG	Q--G
GCCCTGATCCACTTCCTC	GCC------------CTG	ALIHFL	A----L
AATGAAAAGGATGAG	AAT---------GAA	NEKDE	N---E
GCACCCCCA	GCA---CCC	APP	A-P
GAAGTAAAAGTT	GAA------GTA	EVKV	E--V
ATGTTTGAG	ATG---ACT	MFE	M-T
CCGGGTGGA	CCA---GGT	PGG	P-G
AGTTTTTCC	AGG---GAT	SFS	R-D
CTTGCAGCAGCC	CTT------GCA	LAAA	L--A
CCGCTGAGA	GCT---GAG	PLR	A-E
CCAAGTTCC	CCA---AGT	PSS	P-S
GTTACCACT	GTT---ACC	VTT	V-T
CTTCCTCAG	CTT---CTT	LPQ	L-L
CTCTCGTCAGTCTCA	CTC---------TCG	LSSVS	L---S
CACGGAGGC	CAT---GGA	HGG	H-G
CAGAAGAAA	CAG---AAG	QKK	Q-K
GTGGGATAG	TAC---TGA	VG*	Y-*
CGGGCCGCG	CGG---GCC	RAA	R-A
GAAGGCCCG	GAA---GTC	EGP	E-V
CCAAATAAA	CCA---CGT	PNK	P-R
GCAGAGGCC	GCA---GGG	AEA	A-G
GCGGAGGAGGAA	GCG------GAG	AEEE	A--E
CTCGACGAT	CTT---GAC	LDD	L-D
GCTACTACG	GCT---GTT	ATT	A-V
GGGGCCGCAGCT	GGG------GCC	GAAA	G--A
GCCTCCTCT	GCC---TCC	ASS	A-S
AAATGTGAA	AAA---TCT	KCE	K-S
GCCCTGCCAGGGCTC	GCC---------CTG	ALPGL	A---L
ACCTCCTCA	ACC---TCC	TSS	T-S
AGGGAAGAG	AGG---GAA	REE	R-E
GAAAGCTCA	AAG---CTC	ESS	K-L
GATGAAGAG	GAT---GAA	DEE	D-E
GAGGACGAT	GAG---GAC	EDD	E-D
CTGAAAAAG	CTG---AAA	MKK	L-K
GTGGACCTG	GTG---ACC	VDL	V-T
AGCCTGCGC	TCT---CCG	SLR	S-P
CCCACCCAGACG	CCA------GAC	PTQT	P--D
GTCAGCAGT	GTC---AGC	VSS	V-S
GGGGCAGCT	GGG---ACA	GAA	G-T
GTTCCTCAGCCG	GTT------CCT	VPQP	V--P
GTAGAAGAG	ATA---GAA	VEE	I-E
GAGGAGGAGGGGGAA	GAA---------GAG	EEEGE	E---E
AGTTTAGGG	AGT---AAA	SLG	S-K
ACAAATAAC	ATA---AAT	TNN	I-N
GAGAATGCC	GAG---ATT	ENA	E-I
CTTGATTTCAGA	AAA------TTT	LDFR	K--F
AGCGGCGGT	AGC---GGC	SGG	S-G
GCCGGCGGA	GCG---GGC	AGG	A-G
ATGGAGGAA	ATT---GAG	MEE	I-E
GACGGTGGC	GAC---AGT	DGG	D-S
CACTTGAGA	AAC---TCG	HLR	N-S
AATGTGAGCCCC	AAT------GGG	NVSP	N--G
CTTTTCTGG	ATT---TCC	LFW	I-S
AAGGAGGAA	AAG---GAG	KEE	K-E
CGCCTCCTA	CGC---CTC	RLL	R-L
CTTTGTAAACGATACCCA	GTG------------AGT	LCKRYP	V----S
GCTCTACTG	GCT---CTA	ALL	A-L
GGCCGCAGA	GGT---CGC	GRR	G-R
CTCCAGTCGGAT	CTT------CCG	LQSD	L--P
GTGCCCCCT	GTG---CCC	VPP	V-P
GGGATTCGA	GGG---GAT	GIR	G-D
AGGCCAAAG	AGG---TCA	RPK	R-S
AGTGGGGGC	AGT---GGG	SGG	S-G
GAGAGGAACCGC	GAG------AGG	ERNR	E--R
TCAGCACCAGCT	TCA------GCA	SAPA	S--A
GCCACCACCACCACT	GCC---------ACC	ATTTT	A---T
CCTATCCAG	CCC---AGC	PIQ	P-S
CAGCTGTTGCTC	CAG------CTG	QLLL	Q--L
CCTGTCGTT	CCT---GTC	PVV	P-V
CAGGCCGCCGCCGCT	CAG---------GCC	QAAAA	Q---A
ACTCCTCCACCG	ACT------CCT	TPPP	T--P
CAGCCCCCT	CAG---CCC	QPP	Q-P
ATCTCTAGC	ATC---TCT	ISS	I-S
AACCAGCACTGA	AAC------TAG	NQH*	N--*
GAGCGGTCACTC	GAG------CAG	ERSL	E--Q
CAGGAGCGGGAA	CAG------GAG	QERE	Q--E
TCATGTGCC	AAC---AAT	SCA	N-N
TTGCAGCAA	TTG---CAG	MQQ	L-Q
CCTCCACCG	CTT---CTA	PPP	L-L
CCCACCACA	CCC---ACC	PTT	P-T
CCAGACCTATCCACAGAT	CCA------------GAC	PDLSTD	P----D
AAGCAGTGA	AAG---TAG	KQ*	K-*
TTTGAGGATGAA	TTT------GAG	FEDE	F--E
ATCCCGCTAACCTTTTCT	CTG------------GAG	IPLTFS	L----E
CCAGGAATGGCAGGG	CCA---------GGA	PGMAG	P---G
GGCCACCACCAT	GGC------CAC	GHHH	G--H
CAGAGCCAGCCCCATTCT	CAG------------AGC	QSQPHS	Q----S
GGAGAGGAA	GGA---GAG	GEE	G-E
GGCTCCAGCTCT	GGC------TCC	GSSS	G--S
CTCTCCGCCTCT	CTC------TCC	LSAS	L--S
TACTTGTCT	TAT---CAG	YLS	Y-Q
GATGGGGGA	GAC---GGG	DGG	D-G
GTGCGCAGG	GTG---CGC	VRR	V-R
GAGGGTGGG	GAG---GAT	EGG	E-D
CGCTTCCGA	GCT---TCC	RFR	A-S
ATGTTTCGAAGGATCTTG	ATG------------GAT	MFRRIL	M----D
TTGCCCGAGCCCCAACCT	CTG------------CCC	MPEPQP	L----P
ACTCCTCCA	ACT---CCT	TPP	T-P
CCAACATTACCTGAGACT	CCT------------CCA	PTLPET	P----P
GGTTCTTCC	GGT---TCT	GSS	G-S
GAGCCCGTGGCACCT	GAG---------CCC	EPVAP	E---P
CCCTCCTCT	CCC---TCC	PSS	P-S
AGAGCTGCC	AGA---GCT	RAA	R-A
GAAGTGTATGTA	GAA------GTG	EVYV	E--V
CTGTCTTCA	CTG---TCT	MSS	L-S
GGATCTTCC	GGA---TCT	GSS	G-S
GAACTGAGC	AGC---GAG	ELS	S-E
CAGCAGCAGCAGGGACAA	CCG------------CAG	QQQQGQ	P----Q
GGCAGACGT	GGC---AGA	GRR	G-R
GACCACCTGCAT	AAC------AGC	DHLH	N--S
CCCTCGCTGCCCTCT	CCC---------TCG	PSLPS	P---S
TCCACCACT	TCC---ACC	STT	S-T
CAGGAGGAGGAA	CAG------GAG	QEEE	Q--E
AGGGAGGAA	AGG---GAG	REE	R-E
GCCCCCCCA	GCT---CCC	APP	A-P
GTGTCCTCT	GTG---TCC	VSS	V-S
GGCTCCTCT	GGC---TCC	GSS	G-S
GCCAGCCGCACCAGT	GCC---------AGC	ASRTS	A---S
GACAAGTACATTGTCACT	GGT------------GTG	DKYIVT	G----V
AGAAGCACAAGT	AGA------ACC	RSTS	R--T
TCCCTGCCT	TCC---CAG	SLP	S-Q
CTTGGTGGC	CTC---GGT	LGG	L-G
CCTCAGTGA	CCT---TAG	PQ*	P-*
CCATCTTCC	CCA---TCT	PSS	P-S
ACCGCAGCC	ACC---GCA	TAA	T-A
TGGAACCTGTCT	TGG------AGC	WNLS	W--S
AGTGGCGGT	AGT---GGC	SGG	S-G
GCTATTGGCATC	GCT------ATT	AIGI	A--I
GGCTTTTTC	GGC---TTT	GFF	G-F
ATACTGACACAC	GTG------AGG	ILTH	V--R
GTGTTCCGG	GTG---TCC	VFR	V-S
GAGGAAGAGGAAAATGAG	GAA------------GAA	EEEENE	E----E
CCACCTCAGCCA	CCA------CCT	PPQP	P--P
AGAGGAGGC	AGA---GGA	RGG	R-G
CTACAACAG	CTA---CAA	LQQ	L-Q
CTTGGAGGG	CTT---GGA	LGG	L-G
AAACGTGAG	AAA---TGT	KRE	K-C
GTCCGCAGGCGA	TAC------CGC	VRRR	Y--R
TTCGGAAGCCGC	ATC------AGA	FGSR	I--R
GAGGAGGAAGATGAA	GAG---------GAG	EEEDE	E---E
GTCTCAGACTCG	ATC------TCA	VSDS	I--S
TTGGGCAGG	TTG---GAC	MGR	L-D
TTCCACCAT	TTC---CAC	FHH	F-H
CCCGGGGGTGGCGGC	CCC---------GGG	PGGGG	P---G
GGCCCTCCG	GGC---CCT	GPP	G-P
TCCGACGAT	TCG---GAC	SDD	S-D
CAAAATGTGGCATCG	CAG---------AGT	QNVAS	Q---S
TTTCAGTGA	TTT---TAG	FQ*	F-*
GATGAAGAG	GAT---GAA	DEE	D-E
GCTGGAGGC	GCT---GGA	AGG	A-G
GGACCCAGGGGATCACCT	GGA------------TCC	GPRGSP	G----S
GATGAGGAA	GAT---GAG	DEE	D-E
CAGGAGGAA	CAG---GAG	QEE	Q-E
ACAAATAAC	ACA---AGT	TNN	T-S
TTGGGAGGT	TTG---GGA	MGG	L-G
TCTCATCAC	TCT---CAT	SHH	S-H
AGCAAAAAG	AGC---AAA	SKK	S-K
TGGTTATTG	TGG---TTA	WLL	W-L
ACCTACAGT	ACC---GAC	TYS	T-D
GTTGCTTTTCAGGCC	CTC---------GCT	VAFQA	L---A
GCACCACCT	GCA---CCA	APP	A-P
CCCGCCAGT	CCT---CCC	PAS	P-P
ACCCCACCT	ACC---CCA	TPP	T-P
CCCACCACT	CCC---ACC	PTT	P-T
TCTGAGGAA	TCT---GAG	SEE	S-E
TCATCTCCTACGTCA	TCA---------ACT	SSPTS	S---T
GCTTCTTCC	GCT---TTT	ASS	A-F
GTGCCTCCA	GTA---CCT	VPP	V-P
GCCCAGTGA	GCT---TAG	AQ*	A-*
GAAATAAGTCCTTTC	GAA---------GGA	EISPF	E---G
CAGGAAGAG	CAG---GAA	QEE	Q-E
ACGCCGCCA	ACG---CCG	TPP	T-P
CAAGGTGGA	CAA---GGT	QGG	Q-G
GATCCCAGT	GAT---TCC	DPS	D-S
TCTCTTCCACCTTTA	TCT---------CTT	SLPPL	S---L
AGCGCAGCG	AGC---GCA	SAA	S-A
GAAAGAAGG	GAG---AGA	ERR	E-R
AGTAGTGTTTCC	AGC------AGT	SSVS	S--S
CCCGGGGCCGGA	CCT------GGG	PGAG	P--G
GTTTCTTCA	GTT---TCT	VSS	V-S
GAGAGCTCA	GAG---AGC	ESS	E-S
GCAACAACT	GCA---ACA	ATT	A-T
TCTTCAGACCACTCG	TCT---------TCA	SSDHS	S---S
AATGAAGAG	AAT---GAA	NEE	N-E
AGCGATGACGATGAC	AGC---------GAT	SDDDD	S---D
ATAGGAGGG	ATA---GGA	IGG	I-G
GGCTCCAGT	GGA---GCC	GSS	G-A
ACAGCCAGCCCTCCAGCA	ACA------------GCC	TASPPA	T----A
GTTCCCCCG	GTT---CCC	VPP	V-P
GCAATTCGAGATTATGTC	GCT------------AGT	AIRDYV	A----S
GGCGGCGGCAGCGCG	GGC---------AGC	GGGSA	G---S
ACAGAGGAA	ACA---GAG	TEE	T-E
GTCGCCGCAGCCGCA	GTC---------GCC	VAAAA	V---A
AATGGTGGC	AAT---GGT	NGG	N-G
GACATCGCT	GAC---AAC	DIA	D-N
ATGAAGAAA	ATG---AAG	MKK	M-K
CCTTCCTCG	CCT---TCC	PSS	P-S
GACGCCGCG	GAC---GCC	DAA	D-A
GTTCCTCAG	GTA---GCT	VPQ	V-A
AAGCGACGG	AAG---CGA	KRR	K-R
AAAGAACGGGAG	AAA------GAA	KERE	K--E
TGCAGCTCA	TGC---AAC	CSS	C-N
GGTGAGGAA	TGT---GAG	GEE	C-E
AAAGAGGAA	AAA---GAG	KEE	K-E
AAGGAAGAG	AAG---GAA	KEE	K-E
GGTAGAGAG	GGT---ACA	GRE	G-T
GCCGGCGCAGGCACCGGT	GCC------------GAC	AGAGTG	A----D
GGGGATGAC	GGG---GAT	GDD	G-D
GGAGATGGG	GGG---GCT	GDG	G-A
GCACGATAG	GCA---TGA	AR*	A-*
GGAGAGGAA	GGA---GAG	GEE	G-E
TCCTCTGGGTGCCACTCC	TCC------------TCT	SSGCHS	S----S
GCATCATCG	GCT---TCA	ASS	A-S
TCACCTCCTCCA	TCA------CCT	SPPP	S--P
CCTGCTGGTGAAGTGGCC	CCT------------GCT	PAGEVA	P----A
GAGTCATCG	GAG---TCA	ESS	E-S
ACACCAAGG	ACA---CAA	TPR	T-Q
AGTCCCGACCCT	AGT------CCC	SPDP	S--P
GAGGAGCTATGCCCGGAA	GAG------------GAG	EELCPE	E----E
TGGCTCAAGACCCTG	TGG---------CTC	WLKTL	W---L
CGCCCCAGTGGCAGT	CGC---------ACC	RPSGS	R---T
ACGCCACCG	GCG---CCA	TPP	A-P
GAACTCCTG	GAT---TCC	ELL	D-S
TACGCCGCG	TAC---GCC	YAA	Y-A
GGGTCATCG	GGG---TCA	GSS	G-S
AAGGCAGCG	AAG---GCA	KAA	K-A
GCAGAGGAA	GCA---GAG	AEE	A-E
CTAGGGGGT	CTA---GGG	LGG	L-G
CCGGAAGAG	CCG---GAA	PEE	P-E
CTGGCTGCC	CTG---GCT	MAA	L-A
CTGCCTGGGGATGAC	GTT---------ACT	MPGDD	V---T
AGCTGCCAG	CAC---AGC	SCQ	H-S
CACCATGATGAA	CAC------AGT	HHDE	H--S
GTATCCTTATTGACG	GTG---------TAC	VSLLT	V---Y
GCCAGCCCT	GCC---AGC	ASP	A-S
ACGCCCCCA	ACA---CCC	TPP	T-P
GCCCCCAAG	GGT---ACC	APK	G-T
CCGCTGCTA	CCC---TTG	PLL	P-L
CAGCCACCGCCG	CAG------CCA	QPPP	Q--P
CCGCTGTTA	CCG---CTG	PLL	P-L
GTCCCACCCCCT	GTC------CCA	VPPP	V--P
ATTCCACCT	ATT---CCA	IPP	I-P
GGCACTGCTGCCACCACA	GGC------------ACT	GTAATT	G----T
GAGCTTGAGGACCTC	GAG---------CTT	ELEDL	E---L
CAGTATCAC	CAG---AAT	QYH	Q-N
GTTAATTATCCCAAC	GTT---------AAT	VNYPN	V---N
CCTCCCCAGCCA	CCA------CCC	PPQP	P--P
GTATCATCT	GTA---TCA	VSS	V-S
TTGGAGGAA	TTG---GAG	MEE	L-E
TCTCCAGAAGCAGAG	TCT---------TCA	SPEAE	S---S
AATGTTCTTGTA	AAT------GTT	NVLV	N--V
CCCAACACG	CCC---AGC	PNT	P-S
GAAGGTGAGGCTGGG	GAA---------GGT	EGEAG	E---G
GACTCCCCGGGGTCT	GAC---------TCC	DSPGS	D---S
GCCCCTCCG	GCC---CCT	APP	A-P
AAGCGCCGCCGT	AAG------CGC	KRRR	K--R
AAAGATTTTAAGAGAGAC	AAT------------GAT	KDFKRD	N----D
AACAGCCCTCCAGCCAGT	AAC------------AGC	NSPPAS	N----S
GGCTCACGCCCC	GGC------TCA	GSRP	G--S
TCCGGGGGA	TCT---GGG	SGG	S-G
GTTCGCATG	GTG---TGC	VRM	V-C
ATTGATGAC	ATG---GAT	IDD	M-D
CAGCAGGCCTCATGCCAA	CGG------------CAG	QQASCQ	R----Q
CAAACCACA	CAG---ACC	QTT	Q-T
CATAGAAGTAGG	CAT------AGA	HRSR	H--R
GGGATGAGC	GAT---GAG	GMS	D-E
CCAGCTCAGGCC	CCA------GCT	PAQA	P--A
ACTCCCGCG	ACT---CAC	TPA	T-H
GATCTTCTG	GAA---CTT	DLL	E-L
TGTCACAGTCAT	TGT------CAC	CHSH	C--H
CTGGAAGAG	CTG---GAA	MEE	L-E
AGCGGCGGT	AGT---GGC	SGG	S-G
GAGTCTTCA	GAG---TCT	ESS	E-S
AAAGAAGAAGAAGAGGAG	AAA------------GAA	KEEEEE	K----E
AGCCCAAAG	AGC---TCA	SPK	S-S
ACGTCCTCT	ACG---CCC	TSS	T-P
GGAGCTGCTGCG	GGA------GCT	GAAA	G--A
GATGTAGCTGCTACT	GAG---------GGA	DVAAT	E---G
CACCAAGGCTCTAGG	CAC---------AAA	HQGSR	H---K
GATGAAGAG	GAC---GAA	DEE	D-E
GATCAGCTGTGA	GAC------TAG	DQL*	D--*
GACGAGGAAGAAGAAGAA	GAT------------GAG	DEEEEE	D----E
TCTCCATGT	TCT---ACA	SPC	S-T
ATGGAGGAA	ATG---GAG	MEE	M-E
TTAGAAGAG	TTA---GAA	LEE	L-E
TCTGTGAGCAATGATCGT	GCC------------GAG	SVSNDR	A----E
TCAGCAGCG	TCA---GCA	SAA	S-A
AAGAACAAT	AAG---AAC	KNN	K-N
ATACCCCCT	GTG---CCC	IPP	V-P
GAAAAGGAA	GAA---ACG	EKE	E-T
ACGCTCCTT	ACT---CTC	TLL	T-L
ATTTACTCT	ATT---TAC	IYS	I-Y
GAAGGTGCA	GAA---GTT	EGA	E-V
GGCTTGTGT	GGC---TCG	GLC	G-S
AAGCATGAA	AAG---CGT	KHE	K-R
TGCCCTGTATTTGAG	TGC---------TCT	CPVFE	C---S
CAGTTAATATCCTTGCTC	CAG------------TTA	QLISLL	Q----L
GTTGAAGAG	GTT---GAA	VEE	V-E
AGGCTGAGCCTC	AGG------CTG	RLSL	R--L
CTCGGTTCA	CTC---AGT	LGS	L-S
TTTGAAGAG	TTT---GAA	FEE	F-E
GAAGACGAT	GAA---GAC	EDD	E-D
GACGCCTCA	GAC---ACC	DAS	D-T
CTCCCCCCG	CTT---CCC	LPP	L-P
TTTCCTCCG	TTT---CCT	FPP	F-P
GGCTCGTCC	GGT---TCG	GSS	G-S
TCAAACAAT	TCA---AAC	SNN	S-N
CATTCAAGT	CAT---TCA	HSS	H-S
TCAGAGGAA	TCA---GAG	SEE	S-E
GTGAGGACT	ATC---GTG	VRT	I-V
ACAGGAACT	AAG---CAA	TGT	K-Q
GAGGCAGCG	GAG---GCA	EAA	E-A
CTGCCTCCG	CTG---CCT	MPP	L-P
GCGGGAGCT	GCT---GTA	AGA	A-V
CGGGGTGGC	CGG---GGT	RGG	R-G
CGGGGTCCGGGA	CGG------GGT	RGPG	R--G
CCTGGGAACTCGACT	CCT---------GAG	PGNST	P---E
AGCTCGTGA	AGC---TAG	SS*	S-*
AAGTCTTCC	AAG---TCT	KSS	K-S
GACAGCAGT	GAC---AGC	DSS	D-S
GATGTGGGTACC	GAA------GGG	DVGT	E--G
TCTCCAGCC	AGG---CAA	SPA	R-Q
TCTGAAGGTTGTGAG	TCT---------GAA	SEGCE	S---E
CCAGAACAAGAG	CCA------GAA	PEQE	P--E
GATGAGGACTGA	GAA------TAG	DED*	E--*
TTCGAAGAG	TTC---GAA	FEE	F-E
ACAGGAGGG	ACG---GGA	TGG	T-G
GGGCCCCCG	GGA---CCC	GPP	G-P
ACTCCTGCA	ACG---TCT	TPA	T-S
GGGCGCGTG	GCG---TGC	GRV	A-C
CCCTCCTCT	CCC---TCC	PSS	P-S
GACGAGGAC	GAC---GAG	DED	D-E
CAGGAATGTGAGCTGGAG	CAG------------GAA	QECELE	Q----E
TGCCTAAAG	TGC---CCA	CLK	C-P
CCTCTCATT	CCT---GTC	PLI	P-V
ACCGAGGAA	ACA---GAG	TEE	T-E
CACAATAAC	CAC---AAT	HNN	H-N
AAGCACGGG	GCG---CCC	KHG	A-P
AGTGACGAT	AGT---GAC	SDD	S-D
CGACTGCTC	CGA---CTG	RLL	R-L
AAACCACAGCCTGCACCC	AAG------------CCA	KPQPAP	K----P
GTGGCTTCTGTC	GTG------ACT	VASV	V--T
GGAGGAACTGTTAGTGGC	GGA------------GGA	GGTVSG	G----G
AGAAGCTCA	CGA---AGC	RSS	R-S
CGCAGCGGCAGT	CGC------AGC	RSGS	R--S
GGTGTGAAC	GGT---GGG	GVN	G-G
GGCGGCGGCGGCGGCGGT	GGC------------GGC	GGGGGG	G----G
AACTTTTTA	AGA---GCT	NFL	R-A
CAGGAAGAG	CAG---GAA	QEE	Q-E
GGAACCCCCGGG	GGA------GCC	GTPG	G--A
ATTGAAGAG	ATT---GAA	IEE	I-E
TCAGAAGAG	TCA---GAA	SEE	S-E
ACCTCTAGCAGTGGTAGC	ACC------------TCT	TSSSGS	T----S
GCAGAAGAG	ACA---GAA	AEE	T-E
GCCGACGACAACGAT	GCC---------GAC	ADDND	A---D
AGTGCAAAGGTGTCT	TCA---------ACA	SAKVS	S---T
GAACCACCTCTTCCT	GAA---------CCA	EPPLP	E---P
ACCTCATCT	ACC---TCA	TSS	T-S
TTGGGGGCC	ATA---GAG	MGA	I-E
CTGGATGAC	CTG---GAT	MDD	L-D
CAGGACTCAGCT	CAG------GTC	QDSA	Q--V
ATCCTTCTC	ATC---CTT	ILL	I-L
CCTACAGGAGCC	CCT------TCA	PTGA	P--S
CCTCAACAG	CCT---CAA	PQQ	P-Q
GCCAGCCAGAGGACA	GCA---------GTC	ASQRT	A---V
GCAACCACA	GCA---ACC	ATT	A-T
AACGCAGCG	AAC---GCA	NAA	N-A
AGAGAGGAA	AGA---GAG	REE	R-E
CCCGGGGGC	CCC---GGG	PGG	P-G
ACCCAGCAGAGA	AGC------AAG	TQQR	S--K
CTGCCTGAGCCC	CTG------CCT	MPEP	L--P
CAGCTGGAA	CAG---AGG	QLE	Q-R
AGGGACTAT	AGG---GCC	RDY	R-A
CAAGGAGGG	CAA---GGA	QGG	Q-G
CTGCCCCCG	CTG---CCC	MPP	L-P
GCAAGACACAGT	GCA------ACA	ARHS	A--T
CCTATTGCA	CCT---CAT	PIA	P-H
GGTAGAAGG	GGT---AGA	GRR	G-R
CCCTCTAGAGCCCCC	CCC---------ATT	PSRAP	P---I
TATCCTCCC	TAT---CCT	YPP	Y-P
GACGGCACA	GAG---AGC	DGT	E-S
TGGGAGGACGAA	TGG------GAG	WEDE	W--E
GATAAGAAA	GAT---AAG	DKK	D-K
CTGCATCAGCAC	CTA------CAT	MHQH	L--H
TTGGCCCCAGATGCT	TTG---------GCC	MAPDA	L---A
AAACCTTTTTCTCCC	AAA---------ATT	KPFSP	K---I
AGCGCAGCT	AGC---ACA	SAA	S-T
CAGGCTGCG	CAG---GAT	QAA	Q-D
GAGTCTGGATTCTGGTCA	GAG------------TCT	ESGFWS	E----S
GCTGGGGGC	GCT---GGG	AGG	A-G
GGCCGTCAGGACTCA	GGC---------AGT	GRQDS	G---S
GCCTCCTCT	GCC---TCC	ASS	A-S
GCTCCACGCCCTCGCCCC	GCT------------CCA	APRPRP	A----P
ACCTCTTCC	ACC---TCT	TSS	T-S
GATGGTGGA	GAC---AGT	DGG	D-S
AATGAACAGTAC	ACT------GTA	NEQY	T--V
ATGTCCAGT	GTG---TCC	MSS	V-S
TCTGGGCCC	GCT---GTG	SGP	A-V
CAGCCACCC	CAG---CCA	QPP	Q-P
AACTCCTCT	AAC---TCC	NSS	N-S
CCGGAAGAG	CCG---GAA	PEE	P-E
CCAGGATCAGGG	CCA------GGA	PGSG	P--G
GATCTTCTG	GAT---CTT	DLL	D-L
GACTACCAG	GGG---TCC	DYQ	G-S
CCTTCATCT	CCT---TCA	PSS	P-S
CAGGAAGAG	CAG---GAA	QEE	Q-E
TGGGAGCCAGAGCCTTGA	TGG------------TAG	WEPEP*	W----*
CTGGGGGGT	CTG---GGG	MGG	L-G
GTGGAGGAA	GTG---GAG	VEE	V-E
AGCCTGCTGCTC	AGC------CTG	SLLL	S--L
AAACTGAGC	AAG---CAG	KLS	K-Q
CTGAGAAGG	CTG---AGA	MRR	L-R
GAGCTGCCC	GCG---GAG	ELP	A-E
ACAGAGGCTCTAGAAGAA	GCA------------GAG	TEALEE	A----E
AACCACCAT	AAC---CAC	NHH	N-H
TCTGAGGCATATGAA	TCT---------GAG	SEAYE	S---E
CTTCAGCGCTGA	CTT------TAG	LQR*	L--*
GGTGATGAC	GCC---GAT	GDD	A-D
TTTCCAGAAACCGGGCCG	TTT------------CCA	FPETGP	F----P
GCTTCAAGT	GCC---TCA	ASS	A-S
CTTAGCAGT	CTT---AGC	LSS	L-S
GCAGTCAAG	GCG---GGC	AVK	A-G
AAAGTCTGCGTT	GAA------GTC	KVCV	E--V
TTGTTCAGGTTT	TTA------TTC	MFRF	L--F
TTCTCCAGT	TTC---TCC	FSS	F-S
TCAGAGGAA	ACA---GAG	SEE	T-E
TATGAAGAG	CAT---GAA	YEE	H-E
GACCTTTTG	GAC---CTT	DLL	D-L
AGTGGTGCA	AGC---TGT	SGA	S-C
AGATCTGGATCA	AGG------TCT	RSGS	R--S
CCAGATGAC	CTG---GAT	PDD	L-D
ACAACTCCAGGA	TCA------GCT	TTPG	S--A
TCTGGCATGGGT	TCT------GGC	SGMG	S--G
AACCAAAAG	AAC---CGA	NQK	N-R
GGGGAAGAG	GGG---GGA	GEE	G-G
CGCTCCTCA	CGC---TCC	RSS	R-S
GCAGTTATGACA	GCA------GAT	AVMT	A--D
GAGGGAGGCCTGTCCTCT	CAA------------GAA	EGGLSS	Q----E
CAGCCTGAGCCTGAGCCA	CAA------------CCT	QPEPEP	Q----P
CAGCCTCCA	CAG---CCT	QPP	Q-P
CCTACAACC	CCC---ACA	PTT	P-T
CTCAGCAGT	CTC---AGC	LSS	L-S
GAAGGAGGC	GAG---GGA	EGG	E-G
AGTACCTCGTGGACA	AAT---------ACC	STSWT	N---T
GAGCCTCCGCCGCCC	GAA---------CCT	EPPPP	E---P
CCCGTGGTC	CCC---ATG	PVV	P-M
GGCAAGAAA	GGC---AAG	GKK	G-K
GCAAATGACTCC	GCA------AGT	ANDS	A--S
GCGCCGATGCCA	CCA------CCG	APMP	P--P
GCTTTGTTGCTA	GCT------GTG	ALLL	A--V
GGGATGTCC	GGC---AAG	GMS	G-K
GAGGACAGATGTCCT	ATG---------GTC	EDRCP	M---V
GCCGGAGGT	GCC---AGA	AGG	A-R
GGCAGCTCA	GGC---AGC	GSS	G-S
TCCTGGTCT	CAC---AGG	SWS	H-R
AGTGGAGGC	AGT---GGA	SGG	S-G
ATGAGTAGCAGC	ATG------AGT	MSSS	M--S
CCACTGAGA	GAG---CAG	PLR	E-Q
CCAGCAGCT	CCA---GCA	PAA	P-A
GAGCTCCTG	GAG---CTC	ELL	E-L
AGTGAGAAA	AGT---GGG	SEK	S-G
CCAGGTGCA	CCA---CGT	PGA	P-R
TTCTGGACCAGC	CTG------CAG	FWTS	L--Q
AGTGAGGAA	AGT---GAG	SEE	S-E
GCACCCTCTCTACCT	GCA---------CCC	APSLP	A---P
AGTGAGGAGGAA	AGT------GAG	SEEE	S--E
AGCGGGGGA	AGC---GGG	SGG	S-G
CCGAGGAGA	CCG---AGG	PRR	P-R
GTGGGCGGTGGT	GTG------GGC	VGGG	V--G
TTCCTGACTCCACTGGGC	TTC------------CAG	FLTPLG	F----Q
GAGGCCACA	GAG---GTC	EAT	E-V
CTTGGGGGTGGCGGC	CTT---------GGG	LGGGG	L---G
TTGCTGCGTGCC	GTA------AAG	MLRA	V--K
AGACCCCCT	AGA---CCC	RPP	R-P
CACCAGTGCCAA	CAC------TCG	HQCQ	H--S
CTGCCAAAGCCTCAG	CTG---------CTA	MPKPQ	L---L
ATTGGTGAG	CTC---AGT	IGE	L-S
CCCCGCTAT	CCT---CTC	PRY	P-L
GCACGACGT	GCA---CGA	ARR	A-R
GCCTACGTG	GCC---TGC	AYV	A-C
GAAGCGGCC	GAA---GCG	EAA	E-A
AACAGAGTT	AGC---ACA	NRV	S-T
TGGCTGCTGGAGAAGGCC	TGG------------CAG	WLLEKA	W----Q
TCTGAGGAA	TCT---GAG	SEE	S-E
GGTAGTAGC	GGT---AGT	GSS	G-S
TCAGGTGGC	TCC---GGT	SGG	S-G
GCCCGTGGA	GCC---TGT	ARG	A-C
GAATCGGCCTCA	GAA------TCG	ESAS	E--S
GAGTCATCT	GAG---TCA	ESS	E-S
CAAGTTGTA	CAA---GTT	QVV	Q-V
GGGGGAACAGAG	GGG------ACA	GGTE	G--T
AGAGCTGCA	AGA---GCT	RAA	R-A
GGCACCGCT	GGC---AGC	GTA	G-S
CCGCTGCTA	CCA---CTG	PLL	P-L
AGCCACCAT	AGC---CAC	SHH	S-H
GAGCCCCAGCCT	GAG------CCC	EPQP	E--P
CAGTCTGAGTCC	CAG------CCT	QSES	Q--P
AGCGGCGGA	AGC---GGC	SGG	S-G
ATAGAAAGACAGCAAGAG	ATA------------GAA	IERQQE	I----E
ACAGCCTCTGCT	ACA------GCC	TASA	T--A
TTGGTCAAGGATGTT	TTG---------GCC	MVKDV	L---A
TGTCACCAA	TGT---CGC	CHQ	C-R
CTGCAGCAGCAACAGCAA	CTG------------CAG	MQQQQQ	L----Q
CCCAGCCATCAA	CCC------ATC	PSHQ	P--I
ACCTGGGCACAGTGA	ACC---------TAG	TWAQ*	T---*
ACAGAAGAG	ACA---GAA	TEE	T-E
AGGGCAGGGGCG	AGG------GCA	RAGA	R--A
CGCCAGTGA	CGC---TAG	RQ*	R-*
AAGAAAGACAAG	AAG------AAA	KKDK	K--K
AAGGGAGCACAT	AAG------AGA	KGAH	K--R
CATAGTTCA	CAC---AGT	HSS	H-S
TTGAGTTTGGAAGACCAC	TTT------------TTT	MSLEDH	F----F
CACTGGACAGAGTCA	CAC---------CAG	HWTES	H---Q
AACTCTACTTCC	AAC------TCT	NSTS	N--S
TGTTTGCTT	TGT---TTG	CLL	C-L
GATGAAGAG	GAT---GAA	DEE	D-E
CAGACGACA	CAG---ACG	QTT	Q-T
GAGACTTCC	GAG---AAT	ETS	E-N
TCTGGCAAG	TCT---AGC	SGK	S-S
TCCGGCACCACAGTCCAG	TCC------------AGC	SGTTVQ	S----S
AGCGAGGAGGAGGAA	AGT---------GAG	SEEEE	S---E
AGGGGAGGC	AGG---GGA	RGG	R-G
AGACATTTC	AGA---TAT	RHF	R-Y
GCTGTGGTC	GCT---GTG	AVV	A-V
GGCTGTTCC	GGC---GGT	GCS	G-G
ACTCAGTGA	ATT---TAG	TQ*	I-*
CTGGAGGAA	CTG---GAG	MEE	L-E
CTGGCCGTTGCT	TTG------GTC	MAVA	L--V
AAGCCTGTGCCA	AAG------CCT	KPVP	K--P
GCTTCTTCC	GTC---TCT	ASS	V-S
CAGACCTCT	CAG---CCC	QTS	Q-P
GAGTCTTCA	GAG---TCT	ESS	E-S
TTTGGAGGT	TTT---GGA	FGG	F-G
GTACAGTCACCACCCTGA	GTA------------TAG	VQSPP*	V----*
GCACCCACT	GCA---TCC	APT	A-S
AAGGGGGGT	AAA---GGG	KGG	K-G
GAGGGAGGT	GAG---GGA	EGG	E-G
TTGTATCCTTTTAAC	TTG---------GGT	MYPFN	L---G
GAGTGGACA	GAG---AGG	EWT	E-R
CATGGAGGC	CAT---GGA	HGG	H-G
GTGACGTCACCTCAA	TTG---------ATG	VTSPQ	L---M
GATGAGGAA	GAC---GAG	DEE	D-E
TTGAAAAAG	TTG---ACA	MKK	L-T
GTGCCGCCA	GTG---CCG	VPP	V-P
AGTGAAGAAGACGAG	AGT---------GAA	SEEDE	S---E
AAGCTCATA	AAG---CCC	KLI	K-P
ATGCCCACA	GTG---CAC	MPT	V-H
ACTGCTGATTTAGCC	ACT---------GCT	TADLA	T---A
GAGGAAGAAGGAGAG	GAG---------GAA	EEEGE	E---E
ATAGCTGCA	ATA---GCT	IAA	I-A
AGAGGTAAAGAC	AGA------AGT	RGKD	R--S
ACTGCTGCCGCTGCC	ACT---------GCT	TAAAA	T---A
TCGGAAGAGGAGGAG	TCG---------GAA	SEEEE	S---E
GAAAAGAAA	GAA---AAG	EKK	E-K
GCTTTGTGA	GCT---TAG	AL*	A-*
AACCCCAAA	ACC---CGC	NPK	T-R
GTGCGACGG	GTC---CGA	VRR	V-R
GAAGGAGAT	AAG---AGA	EGD	K-R
AGATCCTCT	AGA---TCC	RSS	R-S
AGTGGCGGCGGCGGT	AGT---------GGC	SGGGG	S---G
CAAGGAACT	CAA---GAA	QGT	Q-E
CATGTCAGT	CAT---GCC	HVS	H-A
AGCGGCGGA	AGC---GGC	SGG	S-G
TACGGGGGC	TAC---GGG	YGG	Y-G
GAGCAGTGTCAA	GAG------CAG	EQCQ	E--Q
AAGACTACA	AAG---ACT	KTT	K-T
GACGGTGAC	GAG---AGT	DGD	E-S
AGTAACCAGTGCAAT	AAT---------AAC	SNQCN	N---N
TCCTGGAGGTGA	TCC------TAG	SWR*	S--*
GACGAGGAA	GAT---GAG	DEE	D-E
ATTTCTAAA	ATT---CTT	ISK	I-L
GTTTCTTCC	GTT---TCT	VSS	V-S
GATGAAGAT	GAC---GGA	DED	D-G
AAACGTGTG	AAA---TGT	KRV	K-C
AATACCACT	AAT---AGC	NTT	N-S
CCAGAGCTACTGGAA	CCA---------GAG	PELLE	P---E
CCTGCTGCCGCC	CCT------GCT	PAAA	P--A
GCCCTCCTT	GCC---CTC	ALL	A-L
GATGGTGGC	GAT---GGT	DGG	D-G
CAGCCGAGATCA	CAG------CAG	QPRS	Q--Q
AGAATTGATTTTGGG	AAG---------AAT	RIDFG	K---N
CTATTTTTC	GTA---TTT	LFF	V-F
GCTTTTGAG	TCT---TCT	AFE	S-S
GCAGCTGCCACCGCC	GCA---------GCT	AAATA	A---A
GATGAGGAA	GAT---GAG	DEE	D-E
TACCCGCCC	TAT---CCG	YPP	Y-P
GAGAAAACAGAGACT	GAG---------GAA	EKTET	E---E
GACAGAACCAGG	GAC------AGA	DRTR	D--R
AAAGATGCA	AAA---CAT	KDA	K-H
GTGCAGCCTGTCTGA	GTG---------TAG	VQPV*	V---*
TTCAGTAGC	TTC---AGT	FSS	F-S
CTTCCAAGG	TTC---CAA	LPR	F-Q
CCCACAACAACC	CCC------ACA	PTTT	P--T
TCGCCTCCC	TCG---CCT	SPP	S-P
GAGGAGGAGAAGGAA	GAG---------GAG	EEEKE	E---E
CCTCAGCAACAA	CCT------CAG	PQQQ	P--Q
ACTGTTGTG	ACT---GTT	TVV	T-V
CCTGCTGCA	CCT---GCT	PAA	P-A
GACTGGACA	GAT---GGG	DWT	D-G
CACAGCAGT	CAC---AGC	HSS	H-S
GCCGGCGGCGGCGGG	GCC---------GGC	AGGGG	A---G
GTCAGGCTCGACGACCGT	GTC------------AGG	VRLDDR	V----R
GAAAATAAAGCAAAC	GAA---------AAT	ENKAN	E---N
GCACGGCGC	GCA---CGG	ARR	A-R
AAAGGTGGA	AAA---GGT	KGG	K-G
GACATCAAA	GAG---TCC	DIK	E-S
TCGCCTGGA	TCT---CAT	SPG	S-H
TCTTTTCCATTCAAC	CCG---------TCT	SFPFN	P---S
ACAGAAGAG	ACA---GAA	TEE	T-E
CCCACACTGGCTGCCTCT	CCT------------CCA	PTLAAS	P----P
ACTTCTTCTTCCTCC	ACT---------TCT	TSSSS	T---S
GAGACAACG	GAG---ACA	ETT	E-T
CTCAATAAC	CTC---AAT	LNN	L-N
GGGGTTGTC	GGG---GTT	GVV	G-V
GTGACAACC	GTG---ACA	VTT	V-T
TCTCCATTGTGT	TCT------TCA	SPLC	S--S
TTGACAAAGACT	CTG------CCA	MTKT	L--P
TCTGCTGCC	TCT---GCT	SAA	S-A
AAAGTTGTG	AAA---GTT	KVV	K-V
GCACCCCCG	GCA---CCC	APP	A-P
AAGGTGCAGCCAGTA	AAG---------GTG	KVQPV	K---V
GGTGATCAG	GGT---AGT	GDQ	G-S
AAGCCGAAT	AAA---GTG	KPN	K-V
GACAGCAGT	GAC---AGC	DSS	D-S
GCTGTGGTCAAAGTA	GCT---------CTG	AVVKV	A---L
GCGGGAGAG	GCG---AGA	AGE	A-R
ATCAATAAC	ATC---AAT	INN	I-N
GACAAAGAAAAG	GAC------AAA	DKEK	D--K
CAAGATACTGAC	CAA------GAT	QDTD	Q--D
ACTCATATCCAG	ACT------CCT	THIQ	T--P
ACTTCATGGGAGGCCTCC	ACT------------TCA	TSWEAS	T----S
CTAGAAGAG	CTA---GAA	LEE	L-E
CTGCCGCCACCT	CTG------CCG	MPPP	L--P
GAGGCAGCT	GAG---GTA	EAA	E-V
TGCTTGCTT	TGC---TTG	CLL	C-L
ATAGAGTGA	ATA---TAG	IE*	I-*
ACACCACCCCCG	ACA------CCA	TPPP	T--P
ATGAAAAAG	ATG---AAA	MKK	M-K
GACAGCAGT	AAC---AGC	DSS	N-S
TCCGCAGCAGCGGCAGCG	TCC------------GCA	SAAAAA	S----A
TATAAACCCAAG	TAT------AAA	YKPK	Y--K
GCGCCACCGCCG	GCG------CCA	APPP	A--P
ATGGGTGGCGTGGGA	ATG---------GGT	MGGVG	M---G
TTCAATCCCGAGTAC	CTC---------CAT	FNPEY	L---H
AAAGCCCAGACTGCT	GAA---------GCC	KAQTA	E---A
ACCCCAGTTCCTGAGCCT	ACC------------CCA	TPVPEP	T----P
TGGGAGGAA	TGG---GAG	WEE	W-E
CTAGATACTGAGGTGGAC	CTA------------GAT	LDTEVD	L----D
GCGGTACAT	AAG---ACA	AVH	K-T
AGAGGTGGA	AGA---GGT	RGG	R-G
AACGGAGGC	AAC---GGA	NGG	N-G
AATGAAGAG	CAT---GAA	NEE	H-E
ACTGCTGCC	ACT---GCT	TAA	T-A
ATTCCTGTAACCCCA	ATT---------CCT	IPVTP	I---P
AAGGGCTCT	AAG---GTC	KGS	K-V
GCCGGAGGC	GCC---GGA	AGG	A-G
GAGCTTGAA	GAA---CCT	ELE	E-P
CCCGCGGCC	CCC---GCG	PAA	P-A
GCAAGGAGAGACAGA	GCA---------CAG	ARRDR	A---Q
GCTCCTGTCCCGGTCCCG	GCT------------GCT	APVPVP	A----A
AAAATCATT	AAA---AAC	KII	K-N
CATTTCCCATTT	CAC------TCC	HFPF	H--S
GGCGAAGAG	GCT---GAA	GEE	A-E
GCCCCACCC	GCT---CCA	APP	A-P
CAGCCCAGT	CAG---TCC	QPS	Q-S
GCGCAGCAA	GCA---CAG	AQQ	A-Q
AGCAAAAAG	AGC---AAA	SKK	S-K
GAGAAGAAA	GAG---AAG	EKK	E-K
TCAGCACCAGCC	TCA------GCA	SAPA	S--A
CAGGAGGAA	CAG---GAG	QEE	Q-E
ATGGCTGCC	ATG---GCT	MAA	M-A
AAGACGACT	AAG---ACG	KTT	K-T
AATCTTCTCAGCGAGAGA	AAT------------CAT	NLLSER	N----H
AGGACATCT	AGG---CCA	RTS	R-P
CCCCCTCCCCCCTTGCCA	CCA------------CCT	PPPPLP	P----P
GACGAGGAA	GAC---GAG	DEE	D-E
GTGCGGTAC	GTA---ATG	VRY	V-M
GTAAAAAAG	ATA---AAA	VKK	I-K
TCAACGACCAGT	TCA------GCG	STTS	S--A
TGTTATCCA	TGT---TGT	CYP	C-C
ATACTGCTT	GTA---CTG	ILL	V-L
GGGGAAGAG	GGG---GAA	GEE	G-E
GGAGAGCTGGAA	GGA------GAG	GELE	G--E
CTGCCTTCA	CTG---ACT	MPS	L-T
GATAGTAGCAGC	GAT------AGT	DSSS	D--S
TCAGTGGGTGGC	TCG------CAG	SVGG	S--Q
GGAGATGGA	GGC---GCT	GDG	G-A
GGTAAGAGT	GGA---GTG	GKS	G-V
AAGAAGCTGGGGAAA	CTT---------AAG	KKLGK	L---K
ACCTCCTCT	ACC---TCC	TSS	T-S
TGCCCACCT	TGC---CCA	CPP	C-P
TGGAGGCGT	TGG---AGG	WRR	W-R
CTCCAGCTGTGA	CTC------TAG	LQL*	L--*
GACGGCGGA	GAC---GGC	DGG	D-G
CAGGAGGAA	CAA---GAG	QEE	Q-E
CTGTGCAAG	CTG---AGC	MCK	L-S
GATGAGTCATGTTGA	GAT---------TAG	DESC*	D---*
CGGGCGGCT	CGG---GCG	RAA	R-A
GAATGTAAA	GAA---AGT	ECK	E-S
GCTCCCCCA	GCT---CCC	APP	A-P
GATGAGTCTGAACACTGA	GAT------------TAG	DESEH*	D----*
CATCCATGTCAGAGTTGC	CAT------------GCA	HPCQSC	H----A
GAAGGAGGC	GAA---GGA	EGG	E-G
GAAGATGAC	GAG---GAT	EDD	E-D
CACCCTCCG	CAC---CCT	HPP	H-P
TTGGCTGCA	TTG---GCT	MAA	L-A
GTGACTAGC	GTG---CCT	VTS	V-P
ACCGCCGCT	ACC---GCC	TAA	T-A
TCGCCCCCG	TCA---CCC	SPP	S-P
GTGGCTGCGGCA	GTG------GCT	VAAA	V--A
CCCCCACCC	CCC---CCA	PPP	P-P
CCTTCATCC	CCT---GCA	PSS	P-A
CCTGCATCC	CCT---GGA	PAS	P-G
AAAGACAAG	AAA---CAC	KDK	K-H
CTTCAACAG	CTT---CAA	LQQ	L-Q
