wid.1	wid.2	amino_acid.1	amino_acid.2
ACGGAGCAG	GGG---CAG	TEQ	G-Q
GGCCTCTAG	CAC---TAG	GL*	H-*
GCAGGCCGGCTGCCG	CAC---------CAG	AGRLP	H---Q
TCCACCAGC	AGA---GAC	STS	R-D
GAGCCTCTTGAC	CCT------GAC	EPLD	P--D
TCAGAGAGTATG	AAG------TTC	SESM	K--F
AGCATTGGTGAG	GTT------GAA	SIGE	V--E
CCTGGGCCC	GTG---CCC	PGP	V-P
GCTAAGGAG	AGC---GAG	AKE	S-E
GCCCCCTGT	CCC---TCT	APC	P-S
CAGCTCGTCAGAAAA	ACA---------GAG	QLVRK	T---E
GCCGCGGCCCCGGCG	CCT---------TCC	AAAPA	P---S
CTGGACACG	GCC---GCG	MDT	A-A
AAGAAGTTATATCAA	TCT---------CAA	KKLYQ	S---Q
AAGGACTAA	GCC---TAA	KD*	A-*
GAGCTGTTTGAC	TCT------TCC	ELFD	S--S
GCCAATAGT	AGT---AGT	ANS	S-S
CAGTCTGTTGGTACA	GTT---------ACA	QSVGT	V---T
GCGTCATCATACTTGGCT	TGC------------GTT	ASSYLA	C----V
GACTCCTTGCTG	TCA------CTG	DSLL	S--L
AAGGATGAG	GCT---GAG	KDE	A-E
ACACGGGGC	CTG---GGA	TRG	L-G
AGCTACCCGTTT	CAG------TTT	SYPF	Q--F
GAGTGCAGG	TCC---AGG	ECR	S-R
AGCTATGGC	TCT---GGC	SYG	S-G
GGCTTCCGC	TCT---CGG	GFR	S-R
AGCGGTGGCTCA	GTC------TCA	SGGS	V--S
GCGCATCAGAACGGC	AGT---------GGC	AHQNG	S---G
ATGTTGCTG	TTG---CTG	MLL	L-L
TCCATCCTGGCA	CAT------CGT	SILA	H--R
TCTGGTATA	GAT---ATA	SGI	D-I
AGTTGCCTGCTT	CAG------GAA	SCLL	Q--E
AGTCCTGGCGCT	GCG------TCT	SPGA	A--S
CCGGACTCGACG	TCG------ACG	PDST	S--T
GCTCCCTGCTCT	TTC------AGT	APCS	F--S
AGATGTGCT	TAT---GCT	RCA	Y-A
AAAGAAGAA	GGA---GAA	KEE	G-E
AGCTGCAAG	TAC---AAG	SCK	Y-K
TCTCCAGAGGAA	GGA------GAA	SPEE	G--E
AGTCTTCGA	CCT---CGA	SLR	P-R
GCGACGCCC	ACC---CCA	ATP	T-P
AGCATCTCCCTGTGTACC	TCA------------ACA	SISLCT	S----T
ACCGTCGTGCAG	GGA------CAG	TVVQ	G--Q
AAGGAGGAACATTTT	CGT---------TTT	KEEHF	R---F
GCCCAGAAGCTCCTGAAG	CAG------------AAG	AQKLLK	Q----K
ACCCCACCA	CTA---CCA	TPP	L-P
TCAGAAGTAGCA	GGA------ATA	SEVA	G--I
GTCTCTGCCATGGAG	ACA---------GAG	VSAME	T---E
CAGGTAAAC	GGA---AAC	QVN	G-N
GCACACGCTTCGCCAAGG	CAG------------AGG	AHASPR	Q----R
AGCTTCCCA	TCC---CCA	SFP	S-P
CATATGGGGATGAAC	ATG---------AAC	HMGMN	M---N
CTGTTTGTT	TGT---GTC	MFV	C-V
AAGCCACTGATG	CCA------ATG	KPLM	P--M
AGCCTGGTA	CCT---GTA	SLV	P-V
GACATCCAG	AGC---CAG	DIQ	S-Q
ACAGGCTGC	GTC---TGC	TGC	V-C
TCAGACAAGAAGCTC	AAC---------ATA	SDKKL	N---I
GGCAGCCTGCCC	CAT------CCA	GSLP	H--P
GTGCGAAACAGAGGT	ACA---------GGT	VRNRG	T---G
ACACCTCCA	CTT---CCA	TPP	L-P
AGAGTGCTG	GAG---TAT	RVL	E-Y
TATAAATTC	ATA---TTC	YKF	I-F
GCAAGAAGA	ATG---AGA	ARR	M-R
GAGGAGCTCGGC	CCC------TCC	EELG	P--S
AGTGGTGGTGGC	GAC------AGC	SGGG	D--S
ACCGCCTTG	GAC---CTC	TAL	D-L
ACGGGCTGCGGG	TTC------GGG	TGCG	F--G
ATGTTCTCT	TGT---TCT	MFS	C-S
GAGAGCTGC	AGA---TGC	ESC	R-C
AAACACACCCGCCAG	CCT---------CGG	KHTRQ	P---R
AGGACACTGGCG	CCT------GCC	RTLA	P--A
GCAAACACG	AGC---ACG	ANT	S-T
CGAAGTCTA	AGG---CTG	RSL	R-L
ACACGCCTT	CTC---CTC	TRL	L-L
GAAATACCT	AGG---GGT	EIP	R-G
CTCTGTGGC	TAT---GGC	LCG	Y-G
GCGCCACTGCAG	CAG------CAG	APLQ	Q--Q
GACCTCCCA	CCT---CCC	DLP	P-P
AACCTGAAG	CCT---AAG	NLK	P-K
TCAGGAGAG	GAA---GAG	SGE	E-E
CTCGGGGTGGGCGGG	GAA---------CCG	LGVGG	E---P
TCCTTGGAGAAA	GGG------AAG	SLEK	G--K
TGTGGCGGA	GTG---GAG	CGG	V-E
CTTGGTGGACACTTGTCT	TTG------------TGG	LGGHLS	L----W
TCAAATGAA	AGT---GAG	SNE	S-E
TCTGTGGCA	GGG---CCA	SVA	G-P
TGGCTTCATGTG	CTA------GCC	WLHV	L--A
AAAAACACACTTGGG	CCT---------GGC	KNTLG	P---G
AGCAGGCTGGAT	CCA------GAT	SRLD	P--D
ATGCTGAAG	CTG---GAG	MLK	L-E
TCAATGGGA	AGT---GGA	SMG	S-G
AAGGTCCCG	GGC---CTG	KVP	G-L
AGTCATGCC	CCC---ACC	SHA	P-T
GCAGCGTCCAACTCC	AGT---------TCC	AASNS	S---S
GCGAACACT	AGC---ACC	ANT	S-T
CATGTTGTG	GGA---GCC	HVV	G-A
ACTGAAGAATGCTCGTGA	TAC------------TGA	TEECS*	Y----*
TCTGGCAGG	GAC---AGG	SGR	D-R
AGGTCACTAGGC	CAA------GGT	RSLG	Q--G
CCAGTGGAA	GAG---GAA	PVE	E-E
AGTACCACTACACGAGTA	CAA------------GTA	STTTRV	Q----V
TCTGGGGAC	GAG---GAC	SGD	E-D
AGCGTGAGA	GCA---AGA	SVR	A-R
AAGGAGAAA	GGG---AAA	KEK	G-K
GGTCTACCA	CCA---CCA	GLP	P-P
GGCAGCAGC	AGC---AGC	GSS	S-S
TCGCCGCCGCCG	CGC------CCG	SPPP	R--P
GAAAGAGAA	ACA---GAA	ERE	T-E
TCTGATCAC	GGT---CAC	SDH	G-H
GAGCTACTG	CCA---CTA	ELL	P-L
AAACCATTT	CGA---TTG	KPF	R-L
GAACTGAAA	CCT---GAC	ELK	P-D
GAAATAGAT	AGA---GAT	EID	R-D
GCATGCAAT	TAC---AGT	ACN	Y-S
TCTGGGATG	GAG---GTG	SGM	E-V
AAAACTGAGGCA	GGG------GCA	KTEA	G--A
GCTTTTCCA	TGC---CCT	AFP	C-P
GTTTTTAGG	TCT---CGG	VFR	S-R
CAGAAACACAGGGAG	AGT---------GAG	QKHRE	S---E
ACAGCAGGGAGAGAAAAC	GTG------------AAA	TAGREN	V----K
ACTGAGTGT	GTG---TGT	TEC	V-C
AGTTTTGGTGGAGGT	GCC---------GGC	SFGGG	A---G
TCTGGCTGCCCCCTGGCG	CAG------------CAT	SGCPLA	Q----H
TCTGCCAGC	GAC---AGC	SAS	D-S
AATGTGGAC	GCA---GCC	NVD	A-A
ACACCACCT	CTG---CTT	TPP	L-L
GAAGTTAGGTTTCCT	TCT---------CCC	EVRFP	S---P
ATGCCAGCA	CAA---TCA	MPA	Q-S
ACTGTTCGC	GAG---CGG	TVR	E-R
GCCCCGGCT	CAG---GCT	APA	Q-A
TCCGGCAACTGC	AGC------TGC	SGNC	S--C
ACGGAAAAA	GTC---TGC	TEK	V-C
TCTGGTGGAGTAGGC	GAC---------CAG	SGGVG	D---Q
GCTCCGCCTCCGCCG	CAC---------CCC	APPPP	H---P
CGTGGGGGT	GTG---GGG	RGG	V-G
CGAGGGGGT	GAG---GGT	RGG	E-G
AAGGAAATCCACCCAACG	CGC------------CTG	KEIHPT	R----L
TCAACTGGCTTC	GAT------TTC	STGF	D--F
CTGGCCTTAGCT	TTA------GCT	MALA	L--A
ACGCAGGAGCACTCGGAC	TTG------------AGC	TQEHSD	L----S
GCCCTGCCAGGT	CTA------GGT	ALPG	L--G
TCCGTGCGA	GAG---CCA	SVR	E-P
GCTCACCAC	CTC---CCA	AHH	L-P
