wid.1	wid.2	amino_acid.1	amino_acid.2
GGGAAGAAGGCGGCGGCGGCGGCA	GGGAAGAAG------GCGGCGGCG	GKKAAAAA	GKK--AAA
TCTCCTTATTCTTCCTCTTCTTCCTCTTCC	TCTCCTTAT------------TCTTCCTCT	SPYSSSSSSS	SPY----SSS
CTTTTTGTGATCGTTTCACTG	CTTTCTTGT---GATGGTTCA	LFVIVSL	LSC-DGS
AAGGACGACGAGGAGGAAGAG	AAGGACGAC---GAGGAGGAA	KDDEEEE	KDD-EEE
AGTTCAGAAGTAAAAGTTAAAGTC	AGTTCAGAA------GTAAAAGTT	SSEVKVKV	SSE--VKV
TCCCTGGTCTCCAGCAGCAGT	TCCCTGGTC---TCCAGCAGC	SLVSSSS	SLV-SSS
GCTGGCCAGAGCTGGGCGAGACGC	CTGGCAGAG------CTGGAGGAG	AGQSWARR	LAE--LEE
CCCCTGCAGCCACCGCCACCGCCG	TCCCTGCAG------CCGCCGCTA	PLQPPPPP	SLQ--PPL
GCCAAGTGCGGCGGCGGCGGT	GCTAAGTGC---GGCGGCGGC	AKCGGGG	AKC-GGG
CTGCCCACGCCGCCGCTACTG	CTGCCCACG---CCGATGCTA	MPTPPLL	LPT-PML
TGTGCTGAGGAGGAGGAGGAA	TGTGCAGAG---GAGGAAGAG	CAEEEEE	CAE-EEE
GCCGAGATCTACTACAATGTC	CGAGATCTA---CTACAATGT	AEIYYNV	RDL-LQC
GAGTCATGTAGCAGCAGCAGT	GAGTCTTGT---AGCAGCAGC	ESCSSSS	ESC-SSS
CGAGAAAAGGTAGAGTTCCTT	CGAGAAAAG---GAAATTTAC	REKVEFL	REK-EIY
CCAGTGACAAAAAAGAAAAAG	CCCGTGACA---AAGAAGAAA	PVTKKKK	PVT-KKK
TCACGTTCCTCCAGAAGCCGCTCG	TCACGTTCC------TCCAGAAGC	SRSSRSRS	SRS--SRS
TGCCGGAAGGAGGAAGAAGAG	TGCCGGAAG---GAGGAAGAA	CRKEEEE	CRK-EEE
CCCAGGCAGCTGTTGCTCCTGCTG	CCCAGGCAG------CTGTGGCTC	PRQLLLLL	PRQ--LWL
CTGCAGACTCCACCACCTCCACCACCACCA	CTGCAGACT------------CCACCACCT	MQTPPPPPPP	LQT----PPP
GATGGCCAAATTCTAATTCTGGAA	GATGACAAA------TTCAATTCT	DGQILILE	DDK--FNS
CCCACGCCGCATGATGGAGCATGTCCGAGT	CCCACACCA------------TGTGGTGGA	PTPHDGACPS	PTP----CGG
GGCCACCTTGATGATGACGAT	GGCCACCTT---GATGATGAC	GHLDDDD	GHL-DDD
CACGCCGGCCACCACCATCACCAC	CACGCTGGC------CACCACCAT	HAGHHHHH	HAG--HHH
AGCCATGGCTCCAGCTCTTCTTCC	AGCCATGGC------TCCAGCTCT	SHGSSSSS	SHG--SSS
CAGCAACAGCACCAGCAGGCA	CAGCAGGAG---GAGGCACTG	QQQHQQA	QQE-EAL
GAAAAATCTAAGAAGAAAAAG	GAAAAACCT---AAGAAGAAA	EKSKKKK	EKP-KKK
CCTCAGGATGCCTTGGAAACTCAG	CCTCAGGAC------GATGAGGTA	PQDALETQ	PQD--DEV
CCAGGCATGGAGGAGGAGGAGGAGGAGGAA	CCAGGCATG------------GAGGAAGAG	PGMEEEEEEE	PGM----EEE
GAGCCTGAGCCACAGCCGCAGCCACAGCCA	GAGCCGGAG------------CCTGAGCCG	EPEPQPQPQP	EPE----PEP
CTGCCTTTGCCCGAGCCCCAACCTGAGCCT	CTGCCCCTG------------CCCGAGCCC	MPLPEPQPEP	LPL----PEP
TCCCAGGAGCAGCAGCAGCAGCAA	TCCCAGGAG------CAGCAGCAG	SQEQQQQQ	SQE--QQQ
GTTACAGGGTATTTTTCTTAC	GTTACAGGG---GCCCAGACT	VTGYFSY	VTG-AQT
CAGTCCCCTGATGATGATGAC	CAGTCCCCT---GATGATGAT	QSPDDDD	QSP-DDD
GCATTAGCCCCCCCACCGCCA	GCAGTAGCT---CCCCCACCG	ALAPPPP	AVA-PPP
TCCATAGCCCGCAGTCGCAGTCGG	TCCACAGCG------CGGAGTCGC	SIARSRSR	STA--RSR
ACCTCCCCATCTTCCTCCTCT	ACCTCCCCA---TCTTCCTCC	TSPSSSS	TSP-SSS
GCTTGCTGGAACCTGTCTCTAACC	GCTTGCTGG------AGCCTGTCT	ACWNLSLT	ACW--SLS
TTCGGTAGTGGCGGTGGCGGT	TTCGGTAGT---GGCGGTGGC	FGSGGGG	FGS-GGG
CCTCCCAGAGGTGGTGGCGGTGGAGGT	CCTCCCAGA---------GGTGGCGGC	PPRGGGGGG	PPR---GGG
GAGAGCTGCCAACTCTCCTCG	GAGAGGTGC---CTGCAGAAC	ESCQLSS	ERC-LQN
GGACACAGATACAAGGAAGAG	GGACACAGA---CGTGAGGAA	GHRYKEE	GHR-REE
ACAACCACATCGAACTTATCGAACCTC	ACAACCACA---------TCGAACTTA	TTTSNLSNL	TTT---SNL
TTGCTCATTCAGCAGCAGCAA	TTGCTTATT---CAGCAGCAG	MLIQQQQ	LLI-QQQ
ACATCCGAGACCGCTGCGGCA	ACATCCGAG---GCCGCCGCG	TSETAAA	TSE-AAA
CATTACATGCAGCAGCAGCAA	CATTATATG---CAACAGCAG	HYMQQQQ	HYM-QQQ
TTGTCTAGTGATGATGATGAC	TTGTCCAGT---GATGACGAT	MSSDDDD	LSS-DDD
AGCTGTGACGCGCCTGCGCCTGCA	AGCTGTGAC------GCACCCTCG	SCDAPAPA	SCD--APS
GGCCGAGCTGGAGGCGGGGGC	GCCCGAGCT---GGAGGCGGG	GRAGGGG	ARA-GGG
GAGTTTGGGGAGGAGGAGGAGGAA	GAGTTTGGT------GACGATGAG	EFGEEEEE	EFG--DDE
TCTACTGCTTCTTCCTCCTCG	TCTACTGCT---TTTTCCTCC	STASSSS	STA-FSS
GGCAGTCAAGGTGGAGGAGGT	GGTGGTCAA---GGTGGAGGA	GSQGGGG	GGQ-GGG
TTAATTATCACTCCTTCAGCCTGC	CTAGTCTGT------TCTTATCTA	LIITPSAC	LVC--SYL
ATTCCATCTCTTCCACCTTTACCACCC	ATCCCATCT---------CTTCCACCT	IPSLPPLPP	IPS---LPP
TCTGGAGCTTCTGCACTTGGATCTGCATTG	TCTGCAACA------------TCTGCACTT	SGASALGSAL	SAT----SAL
TCCTCCAAGGAGGAGGAGGAA	TCCTCCAAA---GATGGGGAG	SSKEEEE	SSK-DGE
AGCTCCAGTCCTGGCGCTGGCGGA	TCCACAGCG------TCTCATACT	SSSPGAGG	STA--SHT
AGTTCCCCTGCGATCTCGGCT	AGTTCCCCT---GTGACCTCG	SSPAISA	SSP-VTS
ATCCAGGCAGGAGCAGGGGGA	CCTCTGGTA---GTGGGAGGG	IQAGAGG	PLV-VGG
TTTGGAATAGACAATGGAGTGCCT	TACAGTGTG------GCTGTTAGA	FGIDNGVP	YSV--AVR
CCACCACAACCTCCTCCTCCA	CCACCGCAA---CCTCCCCCT	PPQPPPP	PPQ-PPP
GCCGAAGAAAAGAACAAGAATAAA	GCTGAAAAA------AAGAACAAG	AEEKNKNK	AEK--KNK
CAGGTGGCAGAGGAAGAAGAG	CAGGTAGCA---GAGGAGGAA	QVAEEEE	QVA-EEE
CCAGCAACTGGTGATGATGAC	CCAGTACTG---ACACCATCT	PATGDDD	PVL-TPS
ACTGTTATTCCACCTCCCCCA	ACTGTTATT---CCACCTCCC	TVIPPPP	TVI-PPP
CCCCGTCCTCGCGGCCAGCCC	CCGGCGCCG---CCGCCCAAG	PRPRGQP	PAP-PPK
GCCCCCGGCGTGCCGTCCTGT	GAGCGTGAC---CGTCTGATC	APGVPSC	ERD-RLI
CTGTCTCCAAGGAACAGCTCT	GCATCTCCA---GGTAGCAGC	MSPRNSS	ASP-GSS
AAAGGAAACAGCCCTCCAGCCAGTGAGCCT	AAAGGAAAC------------AGCTCTCCA	KGNSPPASEP	KGN----SSP
TACAAGCACCAAGGCTCTAGGAAGCAG	TACAAGCAC---------AAACGCTCT	YKHQGSRKQ	YKH---KRS
GTAGAAATAAAGAAGAAAAAGAAGAAG	GTTGAAATA---------AAGAAGAAA	VEIKKKKKK	VEI---KKK
AATGACACAGCGGCGGCGGGA	AATGACACA---GCAGCTGAG	NDTAAAG	NDT-AAE
GAAGCTCTCCCCCCGCCCCCA	GAAGCTCTT---CCCCCACCC	EALPPPP	EAL-PPP
CAGAGCGCGCAGCAGCAACAG	CAGAGCGCG---CAGCAGCAA	QSAQQQQ	QSA-QQQ
AATAAGGTGAGGACTGTGTCA	AACAAGATC---GTGGCTCAG	NKVRTVS	NKI-VAQ
CGCAGGCGGGGTCCGGGACCGGGG	CGCAGGCGG------GGTCCGGGA	RRRGPGPG	RRR--GPG
TTCCTGGTGCCGCCGCCGCCA	TTCCTGGTG---CCGCCGCCG	FLVPPPP	FLV-PPP
CAGATACTGCAGCAGCAGCAGCAGCAGCAA	CAGATCCTG------------CAGCAGCAG	QILQQQQQQQ	QIL----QQQ
AAGAACAAGGTGTCAGACGTATAT	AAGAACAAG------CCATGTCAC	KNKVSDVY	KNK--PCH
TTACAGACTGCAGCCGCCGCT	TTACAGACA---GCAGCCGCC	LQTAAAA	LQT-AAA
ATTCGCCTACAGCAGCAGCAA	ATTCGCCTA---CAGCAGCAG	IRLQQQQ	IRL-QQQ
GAGCCCGAGTGGACTTCCACA	CGAGCCCGA---GTGGACTTC	EPEWTST	RAR-VDF
GTTGGGAAGCACGGGGGGACC	TCCCAGGCG---CCCAGCCGG	VGKHGGT	SQA-PSR
CCCAAAGGTGTGAACATTGGC	CCCAAAGGT---GGGCAATCT	PKGVNIG	PKG-GQS
ACCTCTGTCCACAGCTCCTCT	ACCTCGATC---AACAGCTCC	TSVHSSS	TSI-NSS
AATTTGGTCCTCGGCGGCGGCGGT	AATTCGGTC------CCAGTCGGC	NLVLGGGG	NSV--PVG
AAAAGGAAACGGATTCGGATTCGA	AAAAGGAAA------CGGATTCGG	KRKRIRIR	KRK--RIR
CAAGATGCAGAAGAGGAGGAA	CAAGATACA---GAAGAAGAG	QDAEEEE	QDT-EEE
AAGGTGAAGCAGCACTATCCCATTTTTCTG	AAGGTAAAG------------GTGGGAGGT	KVKQHYPIFL	KVK----VGG
TCTGCAGGGAAAGCAGCTGCA	TCTGCAGGG---ACAGCAGCT	SAGKAAA	SAG-TAA
AAGGAGAAGCCCGCCAAGCCTGCT	ACCGAGAAA------AAAAAGAAG	KEKPAKPA	TEK--KKK
CCAGCAGGACCTCAGAAGCAC	CCCAGCTGG---ACCTCAGGG	PAGPQKH	PSW-TSG
GCTAAGCCTCGCCCCTCCTCT	GCTAAGCCG---CCCCTCTCC	AKPRPSS	AKP-PLS
TTCCTGCTTGAGGAGGAGGAGGAA	TTCCTGCTA------GAGGAGGAG	FLLEEEEE	FLL--EEE
CCCCATGATTGCAGCAGCAGT	CCCTGTGAT---CACAGCGGC	PHDCSSS	PCD-HSG
CCAATGATGTCCAGTTCATCT	CCAATGGTG---TCCAGTTCA	PMMSSSS	PMV-SSS
GCAGCTCCAGCTCCTGCGGCTGCACCTGCA	GCAGCTCCG------------GCCCCTGCG	AAPAPAAAPA	AAP----APA
AGAAGCCAGGAAGAGGAGGAA	AGAAGACAG---GAAGAGGAG	RSQEEEE	RRQ-EEE
CTCTGTAGCCTGCTGCTCCTGCTG	CTCTGTAGC------CTGATGCTC	LCSLLLLL	LCS--LML
CAGACAAAAAACCCTACCACTATG	CAGCCAAAA------ACCTCTACC	QTKNPTTM	QPK--TST
TTTGGCAGCCACCACCTTCCA	TTTTCCTCT---CACTGCTGT	FGSHHLP	FSS-HCC
GGCACGGTCTCCTCCTCCTCCTCG	GGCATGGTC------TCCTCCTCC	GTVSSSSS	GMV--SSS
CCTGAAGTAGAGGAGGAGGAGGAA	CCTGAAGTA------GAGGAGGAG	PEVEEEEE	PEV--EEE
GAGGAGGAAGATGAGGACATGGAAGACAAA	GAGAATGAT------------GAGGCTGTC	EEEDEDMEDK	END----EAV
GAGAACGTCCCGCTCGATCTGACCCGA	AAAAATGTC---------CTATTTTTT	ENVPLDLTR	KNV---LFF
TTGGACGACGACTCCTCCGATTCCTCA	CTGGGAGAT---------GCATCTTCC	MDDDSSDSS	LGD---ASS
GAAGACATAGAAGAAGAAGAG	GAAGACATA---GAGGAAGAA	EDIEEEE	EDI-EEE
AAGGAAAGTGAGGAGGAAGAGGAG	AAGGAAAGT------GAGGAGGAA	KESEEEEE	KES--EEE
CCGGGTTCTCCTCCCAACTCTTCA	CCAGTTTCC------CATTCAATC	PGSPPNSS	PVS--HSI
GCCAGCAAGGATGGTGATGAC	CCCAGCAAG---GCTGCTGAT	ASKDGDD	PSK-AAD
GTTCCACAGGCCTCTGTGCCTGGTCTC	GCCCCACAG---------CCCCCTGTG	VPQASVPGL	APQ---PPV
GGGGCTGCAGTAGGGGGCAGCGGCGGTGGT	GGGGCTGCA------------GGAGGGGGC	GAAVGGSGGG	GAA----GGG
CAACTTCTTCAGCAGCAGCAGCAA	CAACTTCTT------CAGCAGCAG	QLLQQQQQ	QLL--QQQ
GGGGGAGCCGGCGTGGCAGTG	GTGGGCACC---GTGCTGGCA	GGAGVAV	VGT-VLA
AAGAAGAAGAAAGACAAGGACAAA	AAGAAGAAG------AAAGACAAG	KKKKDKDK	KKK--KDK
CAATCACCAAGAGGTGCGTCA	CAGTTACCA---GGAGGTGTG	QSPRGAS	QLP-GGV
CAGCAGCAGCAGCAGCCACCACCC	CAGCAACAG------CCGCCGCCA	QQQQQPPP	QQQ--PPP
ACTGTGAAGGGCATGGCCTTCAGT	GTAGTCAGA------TTTCATTCC	TVKGMAFS	VVR--FHS
AACTTGTGCCCGCCGCCGCCA	AGCTTGTGC---CCACCGCCG	NLCPPPP	SLC-PPP
GCTCTACTTCCACCGCCACCACCT	GCTCTGCTT------CCACCTCCA	ALLPPPPP	ALL--PPP
CTAGCACACCAGCAGCAGCAA	CTAGCTCAC---CAGCAGCAG	LAHQQQQ	LAH-QQQ
ACACCTAGAAGGTATTTCTTCATGGTT	AGTCTAAGA---------CTGGCAATC	TPRRYFFMV	SLR---LAI
CTCATTTTGTCAGGAATTGGATTGACACTA	CTCATTTTT------------GTCAGGAAT	LILSGIGLTL	LIF----VRN
CAAACAGCACCACCTACTCCACCAACC	CAAGCGGCG---------CCACCCACT	QTAPPTPPT	QAA---PPT
ATGGAGGATGAGGAAGAAGAG	ATGGAGGAC---GAGGAAGCA	MEDEEEE	MED-EEA
GTGGATTCGGAAGAGGAGGAGGAAGAA	GTGGATTCG---------GAAGAGGAG	VDSEEEEEE	VDS---EEE
CCATCGCAAGGAACTTCAGCC	CCATCTCAA---GAAGCCCCA	PSQGTSA	PSQ-EAP
TTTACATGTAGCTGTGATGAG	GTGCTTTGC---TGCTCCAGT	FTCSCDE	VLC-CSS
ATGAAGAGCGGCGGAGGCGGA	ATGAAGAGC---GGCGGAGGC	MKSGGGG	MKS-GGG
CTGGGGGCCAGTGGTGGCGGA	CCCGGGGCC---GGTGGTGGC	MGASGGG	PGA-GGG
GAGGCTGCCGGTGGCTCATCT	GAGGCTGCC---AGCAGCTCA	EAAGGSS	EAA-SSS
CTACCGCTTCCAAGGTTCCTG	CTACCCTTC---CAAGGTTCC	LPLPRFL	LPF-QGS
CCCGGTTTTCCAGGTCCCCCGGGACCT	CCTGGTTTT---------CCTGGTCCC	PGFPGPPGP	PGF---PGP
AGCGCGGCGGAGGAGGAGGAA	AGCCTGGCG---GAAGAGGAG	SAAEEEE	SLA-EEE
CACTTCATTGTGGGCAGGCTC	CACCTCATT---GGGGCAGGG	HFIVGRL	HLI-GAG
GCATCACCAACGCCTCCGCCA	GCATCACCA---CCGCCTCCG	ASPTPPP	ASP-PPP
CTGCGCCAAGCTGCTGCTGCG	CTGCGCCAG---GCTGCTTCT	MRQAAAA	LRQ-AAS
AACAGTACCAATGGCAGCAATGGCAGT	AACAGTACC---------AATGGCAGC	NSTNGSNGS	NST---NGS
CCTGTTCTAGAAGAGGAGGAA	CCTGCTCTA---GAAGAGGAG	PVLEEEE	PAL-EEE
GCTGGGACCCCAGTTCCTGAGCCTGTTCCG	GCTGGGACC------------CCAGTTCCT	AGTPVPEPVP	AGT----PVP
GCCAGGGCGGTACATAGTGAG	CCCAAGAAG---ACACCACCT	ARAVHSE	PKK-TPP
CCCGCCAACGGAGGCGGCGGT	CCCGCCAAC---GGAGGCGGC	PANGGGG	PAN-GGG
ATTGGAACAGGGACAGGGGCAGGGACAGGA	ATTGGAACA------------GGGACAGGG	IGTGTGAGTG	IGT----GTG
TCACCTCCAGCAGCAGCAGCG	TCACCTCCA---GCAGAAGCA	SPPAAAA	SPP-AEA
AGCCTCAGTGAGGAGGAGGAA	AGCCTCAGT---GAGGAGGAG	SLSEEEE	SLS-EEE
GAGGACCAGGAGGAAGAGGAA	GAGGACCAG---GAGGAAGAG	EDQEEEE	EDQ-EEE
TTCGACCTCGATCCTGATCCTGAC	TTCGACCTG------GATCCTGAT	FDLDPDPD	FDL--DPD
CCTCCTCCCCCTCCCCCCTTGCCACCCCCT	CCACCCCCA------------CCTGCCCCC	PPPPPPLPPP	PPP----PAP
AAAGGCAAATGCCAGGCCCCGTGCCAGTCA	AACGTTAAA------------TGCCAGACC	KGKCQAPCQS	NVK----CQT
AGTCTTTTGGAGGAGGAAGTGGAGGAGGAG	AGTCTTTTG------------GAGGAGGAA	SLLEEEVEEE	SLL----EEE
CCAGGAATGGCTCAGGCTCAGGCC	CCAGGAATG------GCTCCGGCT	PGMAQAQA	PGM--APA
TTCCTCTCCCTTCTCCTCCTCCTT	CTCCTGTCC------CTGCTCCTC	FLSLLLLL	LLS--LLL
GTCAAGGAGTTGCTGCTGCTC	TGGCAGCAG---TCGCGGCCG	VKELLLL	WQQ-SRP
GGCGGTGGTGGCGCTGGCGGCCGTGGT	GCGGCGGGG---------GGCGCTGGC	GGGGAGGRG	AAG---GAG
AACCGAGAGCCTCCTCCTCCG	AGCCAAGAC---CCTCCTCCT	NREPPPP	SQD-PPP
ACCCTGTATGATGATGATGATGATGAC	ACCCTGTAT---------GATGATGAT	TLYDDDDDD	TLY---DDD
GATGAAGAAGACGAGGAGGAT	GATGAAGAG---GAAGAGGAG	DEEDEED	DEE-EEE
GCGCCCCAGGGCGGCGGCGGG	GCGCCCCAG---GGCAGCAGC	APQGGGG	APQ-GSS
GAAGAGTATGAGGAGGAGGAA	GAGGAGTAT---GATGAAGAG	EEYEEEE	EEY-DEE
AAAGCGGTGGCTGCGGCAGCGGCG	AAAGCCGTG------GCTGCGGCA	KAVAAAAA	KAV--AAA
CCCGGGGACGCAGCAGCCGCT	CCCGGGGAC---GCTGCAGCC	PGDAAAA	PGD-AAA
GATACACCTGCATCCAGCAGT	GACACACCT---GGATTCAGC	DTPASSS	DTP-GFS
ACACCTGCATCCAGCAGCAGT	ACACCTGCA---TCCAGCAGC	TPASSSS	TPA-SSS
ACACCTGCATCCAGCAGCAGT	ACACCTGCA---TCCAGCAGC	TPASSSS	TPA-SSS
