wid.1	wid.2	amino_acid.1	amino_acid.2
GAACAGAAGACAGACACTTTC	CAGGAGAAA---GGCACTTTC	EQKTDTF	QEK-GTF
TCAAGGGTGTTAGGAAGCTAT	AGTAAGAAA---GGTTCAATA	SRVLGSY	SKK-GSI
CCAGAGAAGCCTGGGGAGCTCTCAGCCTCC	GAGGAGTCA------------TCAGGCTTC	PEKPGELSAS	EES----SGF
AAAAACGAGGTTCAGGAAACTGGC	GAGAGTGAG------GAACCTGAC	KNEVQETG	ESE--EPD
ACATTCATACCTGAAAGATGTCAGTTGGAC	GGAACACTT------------TGGTTACAC	TFIPERCQLD	GTL----WLH
TTGCTGCTGTCGCTGCTTCTC	CTGCTGTTG---CTGCTTCTG	MLLSLLL	LLL-LLL
TCTACCACTGCCAATAAAGAG	ACCACTACC---AATAAAGAG	STTANKE	TTT-NKE
TCCTCCACTGCTGCCACCTCAAAC	ATTGTCTGC------AAGGGCTGG	SSTAATSN	IVC--KGW
AGAGAGTGCGGTGCTGACTCA	GAGGGCTGT---GCCGAGTCA	RECGADS	EGC-AES
CCGCTGTTGCTGCCACTGTCATTG	TGTTTGCTC------AATGTCGTG	PLLLPLSL	CLL--NVV
GAGATGACTATTAAAACTTAG	AGAGGAGAT---GACTATTAA	EMTIKT*	RGD-DY*
GCCACGGTTCACCCGCCAGGC	AGTGCTGCC---CCACAAGGC	ATVHPPG	SAA-PQG
GACATCTTTGATGCTAAGAAT	ACATCTTTT---GCTAAGCTG	DIFDAKN	TSF-AKL
GAGCTGAAACCCAAAGCTCCA	CCGGCACAG---AGGATGCCT	ELKPKAP	PAQ-RMP
TTAGACGACTACCTGGACAAC	GAGGATGAC---CTGGACAAC	LDDYLDN	EDD-LDN
TACAGCTTGAAATCCAAAGGC	AGTTCTGTC---TTCTTTGGT	YSLKSKG	SSV-FFG
AGTCGTGCCGGAGAGTCTGTGGAGAAA	GCAGCTGCT---------GTGGAGAAA	SRAGESVEK	AAA---VEK
CCGACGTCACTGTTGTCTACC	AACTCATCT---TTGTCCACT	PTSLLST	NSS-LST
CGAGCGGCGGGCTGGAGGGCG	GAGCGGCGG---CTGGAGGCG	RAAGWRA	ERR-LEA
TCCCCTCCTGCAGTCCTAGAGAGTCCT	GCAGCCCCA---------GAGAGCCCT	SPPAVLESP	AAP---ESP
CAGGGCTCAGTGCCACTGCTG	GCTTCTGCA---CCTTTTCTG	QGSVPLL	ASA-PFL
GTGCTAGTCGGGAACATCAAC	CTCAGCGTG---ACTACAGGG	VLVGNIN	LSV-TTG
ACAGAGGTTGGGAATGAGGTA	GGTACAACA---TCACTGGTA	TEVGNEV	GTT-SLV
GCTTCATCTTCTCCTTTCAAT	TCATCCTCT---CCTTTCAGT	ASSSPFN	SSS-PFS
GATGGAGAGATAAGAAAAGAAAAAATT	AGGAAGGAA---------GAAAAAACT	DGEIRKEKI	RKE---EKT
GAAGAGGCCTGGCTTCCATACGGCAGACCA	CCCCAAAGT------------CCCCAGATT	EEAWLPYGRP	PQS----PQI
TGCCCCCTCGGGGTGGGCGGGGCTAGT	GATGAAGAA---------CCGTCAGAC	CPLGVGGAS	DEE---PSD
AAGCTCTCCACCGGCGACGACGGT	TTCCCAAGC------GGTGACATT	KLSTGDDG	FPS--GDI
GGCTGCTGTAAATTCGGGTCAGAGAGT	AATTGCATG---------TCACAGAGT	GCCKFGSES	NCM---SQS
TTAAATCTGGTCAGTCTACCACCT	CTGGCAGTC------CTGCCGACT	LNLVSLPP	LAV--LPT
TCCACAGCAGCGTCCAACTCCAAGTTC	GGGCCCAGT---------TCCAAGCTC	STAASNSKF	GPS---SKL
TTCTCCCGCCTGGTCTGTGACAACACT	CTTCACAGA---------GAAGCAACG	FSRLVCDNT	LHR---EAT
ACATCATCTGGCCAGGCCAAA	TGCTCTGCC---CAGGCCAAA	TSSGQAK	CSA-QAK
AGTTCATCTGGTAAAACGGGA	TCATCTGCT---AAAACAGGA	SSSGKTG	SSA-KTG
AGCGAAGGCGAAAGTTCCAAA	GAAGAGGGA---AGCTCCAGA	SEGESSK	EEG-SSR
ACTTGTACTGAGTGTGGACTC	TACGCTGTG---TGTGGACCC	TCTECGL	YAV-CGP
TGTGTCGGGGAGGAAGGCCAA	GTCTGGCCC---GGAGGCCAG	CVGEEGQ	VWP-GGQ
AAAGCCAAAGCGGAAGCAGAAGCTGTTGTT	GCAGCAAAA------------GACGCTATT	KAKAEAEAVV	AAK----DAI
ACCCCACCCCCCCTGCCAGGC	CCACCGCCC---CTGCCAGGC	TPPPLPG	PPP-LPG
AGTGCATCAACTGGCTTCCAAGAA	TTAGCTGAT------TTCCAAGAA	SASTGFQE	LAD--FQE
