wid.1	wid.2	amino_acid.1	amino_acid.2
GAACAGAAGACAGACACTTTC	---CAGGAGAAAGGCACTTTC	EQKTDTF	-QEKGTF
TCAAGGGTGTTAGGAAGCTAT	---AGTAAGAAAGGTTCAATA	SRVLGSY	-SKKGSI
CCAGAGAAGCCTGGGGAGCTCTCAGCCTCC	------------GAGGAGTCATCAGGCTTC	PEKPGELSAS	----EESSGF
AAAAACGAGGTTCAGGAAACTGGC	------GAGAGTGAGGAACCTGAC	KNEVQETG	--ESEEPD
ACATTCATACCTGAAAGATGTCAGTTGGAC	------------GGAACACTTTGGTTACAC	TFIPERCQLD	----GTLWLH
TTGCTGCTGTCGCTGCTTCTC	---CTGCTGTTGCTGCTTCTG	MLLSLLL	-LLLLLL
TCTACCACTGCCAATAAAGAG	---ACCACTACCAATAAAGAG	STTANKE	-TTTNKE
TCCTCCACTGCTGCCACCTCAAAC	------ATTGTCTGCAAGGGCTGG	SSTAATSN	--IVCKGW
AGAGAGTGCGGTGCTGACTCA	---GAGGGCTGTGCCGAGTCA	RECGADS	-EGCAES
CCGCTGTTGCTGCCACTGTCATTG	------TGTTTGCTCAATGTCGTG	PLLLPLSL	--CLLNVV
GAGATGACTATTAAAACTTAG	---AGAGGAGATGACTATTAA	EMTIKT*	-RGDDY*
GCCACGGTTCACCCGCCAGGC	---AGTGCTGCCCCACAAGGC	ATVHPPG	-SAAPQG
GACATCTTTGATGCTAAGAAT	---ACATCTTTTGCTAAGCTG	DIFDAKN	-TSFAKL
GAGCTGAAACCCAAAGCTCCA	---CCGGCACAGAGGATGCCT	ELKPKAP	-PAQRMP
TTAGACGACTACCTGGACAAC	---GAGGATGACCTGGACAAC	LDDYLDN	-EDDLDN
TACAGCTTGAAATCCAAAGGC	---AGTTCTGTCTTCTTTGGT	YSLKSKG	-SSVFFG
AGTCGTGCCGGAGAGTCTGTGGAGAAA	---------GCAGCTGCTGTGGAGAAA	SRAGESVEK	---AAAVEK
CCGACGTCACTGTTGTCTACC	---AACTCATCTTTGTCCACT	PTSLLST	-NSSLST
CGAGCGGCGGGCTGGAGGGCG	---GAGCGGCGGCTGGAGGCG	RAAGWRA	-ERRLEA
TCCCCTCCTGCAGTCCTAGAGAGTCCT	---------GCAGCCCCAGAGAGCCCT	SPPAVLESP	---AAPESP
CAGGGCTCAGTGCCACTGCTG	---GCTTCTGCACCTTTTCTG	QGSVPLL	-ASAPFL
GTGCTAGTCGGGAACATCAAC	---CTCAGCGTGACTACAGGG	VLVGNIN	-LSVTTG
ACAGAGGTTGGGAATGAGGTA	---GGTACAACATCACTGGTA	TEVGNEV	-GTTSLV
GCTTCATCTTCTCCTTTCAAT	---TCATCCTCTCCTTTCAGT	ASSSPFN	-SSSPFS
GATGGAGAGATAAGAAAAGAAAAAATT	---------AGGAAGGAAGAAAAAACT	DGEIRKEKI	---RKEEKT
GAAGAGGCCTGGCTTCCATACGGCAGACCA	------------CCCCAAAGTCCCCAGATT	EEAWLPYGRP	----PQSPQI
TGCCCCCTCGGGGTGGGCGGGGCTAGT	---------GATGAAGAACCGTCAGAC	CPLGVGGAS	---DEEPSD
AAGCTCTCCACCGGCGACGACGGT	------TTCCCAAGCGGTGACATT	KLSTGDDG	--FPSGDI
GGCTGCTGTAAATTCGGGTCAGAGAGT	---------AATTGCATGTCACAGAGT	GCCKFGSES	---NCMSQS
TTAAATCTGGTCAGTCTACCACCT	------CTGGCAGTCCTGCCGACT	LNLVSLPP	--LAVLPT
TCCACAGCAGCGTCCAACTCCAAGTTC	---------GGGCCCAGTTCCAAGCTC	STAASNSKF	---GPSSKL
TTCTCCCGCCTGGTCTGTGACAACACT	---------CTTCACAGAGAAGCAACG	FSRLVCDNT	---LHREAT
ACATCATCTGGCCAGGCCAAA	---TGCTCTGCCCAGGCCAAA	TSSGQAK	-CSAQAK
AGTTCATCTGGTAAAACGGGA	---TCATCTGCTAAAACAGGA	SSSGKTG	-SSAKTG
AGCGAAGGCGAAAGTTCCAAA	---GAAGAGGGAAGCTCCAGA	SEGESSK	-EEGSSR
ACTTGTACTGAGTGTGGACTC	---TACGCTGTGTGTGGACCC	TCTECGL	-YAVCGP
TGTGTCGGGGAGGAAGGCCAA	---GTCTGGCCCGGAGGCCAG	CVGEEGQ	-VWPGGQ
AAAGCCAAAGCGGAAGCAGAAGCTGTTGTT	------------GCAGCAAAAGACGCTATT	KAKAEAEAVV	----AAKDAI
ACCCCACCCCCCCTGCCAGGC	---CCACCGCCCCTGCCAGGC	TPPPLPG	-PPPLPG
AGTGCATCAACTGGCTTCCAAGAA	------TTAGCTGATTTCCAAGAA	SASTGFQE	--LADFQE
