wid.1	wid.2	amino_acid.1	amino_acid.2
GGGAAGAAGGCGGCGGCGGCGGCA	GGGAAGAAGGCGGCGGCG------	GKKAAAAA	GKKAAA--
TCTCCTTATTCTTCCTCTTCTTCCTCTTCC	TCTCCTTATTCTTCCTCT------------	SPYSSSSSSS	SPYSSS----
CTTTTTGTGATCGTTTCACTG	CTTTCTTGTGATGGTTCA---	LFVIVSL	LSCDGS-
AAGGACGACGAGGAGGAAGAG	AAGGACGACGAGGAGGAA---	KDDEEEE	KDDEEE-
AGTTCAGAAGTAAAAGTTAAAGTC	AGTTCAGAAGTAAAAGTT------	SSEVKVKV	SSEVKV--
TCCCTGGTCTCCAGCAGCAGT	TCCCTGGTCTCCAGCAGC---	SLVSSSS	SLVSSS-
GCTGGCCAGAGCTGGGCGAGACGC	CTGGCAGAGCTGGAGGAG------	AGQSWARR	LAELEE--
CCCCTGCAGCCACCGCCACCGCCG	TCCCTGCAGCCGCCGCTA------	PLQPPPPP	SLQPPL--
GCCAAGTGCGGCGGCGGCGGT	GCTAAGTGCGGCGGCGGC---	AKCGGGG	AKCGGG-
CTGCCCACGCCGCCGCTACTG	CTGCCCACGCCGATGCTA---	MPTPPLL	LPTPML-
TGTGCTGAGGAGGAGGAGGAA	TGTGCAGAGGAGGAAGAG---	CAEEEEE	CAEEEE-
GCCGAGATCTACTACAATGTC	CGAGATCTACTACAATGT---	AEIYYNV	RDLLQC-
GAGTCATGTAGCAGCAGCAGT	GAGTCTTGTAGCAGCAGC---	ESCSSSS	ESCSSS-
CGAGAAAAGGTAGAGTTCCTT	CGAGAAAAGGAAATTTAC---	REKVEFL	REKEIY-
CCAGTGACAAAAAAGAAAAAG	CCCGTGACAAAGAAGAAA---	PVTKKKK	PVTKKK-
TCACGTTCCTCCAGAAGCCGCTCG	TCACGTTCCTCCAGAAGC------	SRSSRSRS	SRSSRS--
TGCCGGAAGGAGGAAGAAGAG	TGCCGGAAGGAGGAAGAA---	CRKEEEE	CRKEEE-
CCCAGGCAGCTGTTGCTCCTGCTG	CCCAGGCAGCTGTGGCTC------	PRQLLLLL	PRQLWL--
CTGCAGACTCCACCACCTCCACCACCACCA	CTGCAGACTCCACCACCT------------	MQTPPPPPPP	LQTPPP----
GATGGCCAAATTCTAATTCTGGAA	GATGACAAATTCAATTCT------	DGQILILE	DDKFNS--
CCCACGCCGCATGATGGAGCATGTCCGAGT	CCCACACCATGTGGTGGA------------	PTPHDGACPS	PTPCGG----
GGCCACCTTGATGATGACGAT	GGCCACCTTGATGATGAC---	GHLDDDD	GHLDDD-
CACGCCGGCCACCACCATCACCAC	CACGCTGGCCACCACCAT------	HAGHHHHH	HAGHHH--
AGCCATGGCTCCAGCTCTTCTTCC	AGCCATGGCTCCAGCTCT------	SHGSSSSS	SHGSSS--
CAGCAACAGCACCAGCAGGCA	CAGCAGGAGGAGGCACTG---	QQQHQQA	QQEEAL-
GAAAAATCTAAGAAGAAAAAG	GAAAAACCTAAGAAGAAA---	EKSKKKK	EKPKKK-
CCTCAGGATGCCTTGGAAACTCAG	CCTCAGGACGATGAGGTA------	PQDALETQ	PQDDEV--
CCAGGCATGGAGGAGGAGGAGGAGGAGGAA	CCAGGCATGGAGGAAGAG------------	PGMEEEEEEE	PGMEEE----
GAGCCTGAGCCACAGCCGCAGCCACAGCCA	GAGCCGGAGCCTGAGCCG------------	EPEPQPQPQP	EPEPEP----
CTGCCTTTGCCCGAGCCCCAACCTGAGCCT	CTGCCCCTGCCCGAGCCC------------	MPLPEPQPEP	LPLPEP----
TCCCAGGAGCAGCAGCAGCAGCAA	TCCCAGGAGCAGCAGCAG------	SQEQQQQQ	SQEQQQ--
GTTACAGGGTATTTTTCTTAC	GTTACAGGGGCCCAGACT---	VTGYFSY	VTGAQT-
CAGTCCCCTGATGATGATGAC	CAGTCCCCTGATGATGAT---	QSPDDDD	QSPDDD-
GCATTAGCCCCCCCACCGCCA	GCAGTAGCTCCCCCACCG---	ALAPPPP	AVAPPP-
TCCATAGCCCGCAGTCGCAGTCGG	TCCACAGCGCGGAGTCGC------	SIARSRSR	STARSR--
ACCTCCCCATCTTCCTCCTCT	ACCTCCCCATCTTCCTCC---	TSPSSSS	TSPSSS-
GCTTGCTGGAACCTGTCTCTAACC	GCTTGCTGGAGCCTGTCT------	ACWNLSLT	ACWSLS--
TTCGGTAGTGGCGGTGGCGGT	TTCGGTAGTGGCGGTGGC---	FGSGGGG	FGSGGG-
CCTCCCAGAGGTGGTGGCGGTGGAGGT	CCTCCCAGAGGTGGCGGC---------	PPRGGGGGG	PPRGGG---
GAGAGCTGCCAACTCTCCTCG	GAGAGGTGCCTGCAGAAC---	ESCQLSS	ERCLQN-
GGACACAGATACAAGGAAGAG	GGACACAGACGTGAGGAA---	GHRYKEE	GHRREE-
ACAACCACATCGAACTTATCGAACCTC	ACAACCACATCGAACTTA---------	TTTSNLSNL	TTTSNL---
TTGCTCATTCAGCAGCAGCAA	TTGCTTATTCAGCAGCAG---	MLIQQQQ	LLIQQQ-
ACATCCGAGACCGCTGCGGCA	ACATCCGAGGCCGCCGCG---	TSETAAA	TSEAAA-
CATTACATGCAGCAGCAGCAA	CATTATATGCAACAGCAG---	HYMQQQQ	HYMQQQ-
TTGTCTAGTGATGATGATGAC	TTGTCCAGTGATGACGAT---	MSSDDDD	LSSDDD-
AGCTGTGACGCGCCTGCGCCTGCA	AGCTGTGACGCACCCTCG------	SCDAPAPA	SCDAPS--
GGCCGAGCTGGAGGCGGGGGC	GCCCGAGCTGGAGGCGGG---	GRAGGGG	ARAGGG-
GAGTTTGGGGAGGAGGAGGAGGAA	GAGTTTGGTGACGATGAG------	EFGEEEEE	EFGDDE--
TCTACTGCTTCTTCCTCCTCG	TCTACTGCTTTTTCCTCC---	STASSSS	STAFSS-
GGCAGTCAAGGTGGAGGAGGT	GGTGGTCAAGGTGGAGGA---	GSQGGGG	GGQGGG-
TTAATTATCACTCCTTCAGCCTGC	CTAGTCTGTTCTTATCTA------	LIITPSAC	LVCSYL--
ATTCCATCTCTTCCACCTTTACCACCC	ATCCCATCTCTTCCACCT---------	IPSLPPLPP	IPSLPP---
TCTGGAGCTTCTGCACTTGGATCTGCATTG	TCTGCAACATCTGCACTT------------	SGASALGSAL	SATSAL----
TCCTCCAAGGAGGAGGAGGAA	TCCTCCAAAGATGGGGAG---	SSKEEEE	SSKDGE-
AGCTCCAGTCCTGGCGCTGGCGGA	TCCACAGCGTCTCATACT------	SSSPGAGG	STASHT--
AGTTCCCCTGCGATCTCGGCT	AGTTCCCCTGTGACCTCG---	SSPAISA	SSPVTS-
ATCCAGGCAGGAGCAGGGGGA	CCTCTGGTAGTGGGAGGG---	IQAGAGG	PLVVGG-
TTTGGAATAGACAATGGAGTGCCT	TACAGTGTGGCTGTTAGA------	FGIDNGVP	YSVAVR--
CCACCACAACCTCCTCCTCCA	CCACCGCAACCTCCCCCT---	PPQPPPP	PPQPPP-
GCCGAAGAAAAGAACAAGAATAAA	GCTGAAAAAAAGAACAAG------	AEEKNKNK	AEKKNK--
CAGGTGGCAGAGGAAGAAGAG	CAGGTAGCAGAGGAGGAA---	QVAEEEE	QVAEEE-
CCAGCAACTGGTGATGATGAC	CCAGTACTGACACCATCT---	PATGDDD	PVLTPS-
ACTGTTATTCCACCTCCCCCA	ACTGTTATTCCACCTCCC---	TVIPPPP	TVIPPP-
CCCCGTCCTCGCGGCCAGCCC	CCGGCGCCGCCGCCCAAG---	PRPRGQP	PAPPPK-
GCCCCCGGCGTGCCGTCCTGT	GAGCGTGACCGTCTGATC---	APGVPSC	ERDRLI-
CTGTCTCCAAGGAACAGCTCT	GCATCTCCAGGTAGCAGC---	MSPRNSS	ASPGSS-
AAAGGAAACAGCCCTCCAGCCAGTGAGCCT	AAAGGAAACAGCTCTCCA------------	KGNSPPASEP	KGNSSP----
TACAAGCACCAAGGCTCTAGGAAGCAG	TACAAGCACAAACGCTCT---------	YKHQGSRKQ	YKHKRS---
GTAGAAATAAAGAAGAAAAAGAAGAAG	GTTGAAATAAAGAAGAAA---------	VEIKKKKKK	VEIKKK---
AATGACACAGCGGCGGCGGGA	AATGACACAGCAGCTGAG---	NDTAAAG	NDTAAE-
GAAGCTCTCCCCCCGCCCCCA	GAAGCTCTTCCCCCACCC---	EALPPPP	EALPPP-
CAGAGCGCGCAGCAGCAACAG	CAGAGCGCGCAGCAGCAA---	QSAQQQQ	QSAQQQ-
AATAAGGTGAGGACTGTGTCA	AACAAGATCGTGGCTCAG---	NKVRTVS	NKIVAQ-
CGCAGGCGGGGTCCGGGACCGGGG	CGCAGGCGGGGTCCGGGA------	RRRGPGPG	RRRGPG--
TTCCTGGTGCCGCCGCCGCCA	TTCCTGGTGCCGCCGCCG---	FLVPPPP	FLVPPP-
CAGATACTGCAGCAGCAGCAGCAGCAGCAA	CAGATCCTGCAGCAGCAG------------	QILQQQQQQQ	QILQQQ----
AAGAACAAGGTGTCAGACGTATAT	AAGAACAAGCCATGTCAC------	KNKVSDVY	KNKPCH--
TTACAGACTGCAGCCGCCGCT	TTACAGACAGCAGCCGCC---	LQTAAAA	LQTAAA-
ATTCGCCTACAGCAGCAGCAA	ATTCGCCTACAGCAGCAG---	IRLQQQQ	IRLQQQ-
GAGCCCGAGTGGACTTCCACA	CGAGCCCGAGTGGACTTC---	EPEWTST	RARVDF-
GTTGGGAAGCACGGGGGGACC	TCCCAGGCGCCCAGCCGG---	VGKHGGT	SQAPSR-
CCCAAAGGTGTGAACATTGGC	CCCAAAGGTGGGCAATCT---	PKGVNIG	PKGGQS-
ACCTCTGTCCACAGCTCCTCT	ACCTCGATCAACAGCTCC---	TSVHSSS	TSINSS-
AATTTGGTCCTCGGCGGCGGCGGT	AATTCGGTCCCAGTCGGC------	NLVLGGGG	NSVPVG--
AAAAGGAAACGGATTCGGATTCGA	AAAAGGAAACGGATTCGG------	KRKRIRIR	KRKRIR--
CAAGATGCAGAAGAGGAGGAA	CAAGATACAGAAGAAGAG---	QDAEEEE	QDTEEE-
AAGGTGAAGCAGCACTATCCCATTTTTCTG	AAGGTAAAGGTGGGAGGT------------	KVKQHYPIFL	KVKVGG----
TCTGCAGGGAAAGCAGCTGCA	TCTGCAGGGACAGCAGCT---	SAGKAAA	SAGTAA-
AAGGAGAAGCCCGCCAAGCCTGCT	ACCGAGAAAAAAAAGAAG------	KEKPAKPA	TEKKKK--
CCAGCAGGACCTCAGAAGCAC	CCCAGCTGGACCTCAGGG---	PAGPQKH	PSWTSG-
GCTAAGCCTCGCCCCTCCTCT	GCTAAGCCGCCCCTCTCC---	AKPRPSS	AKPPLS-
TTCCTGCTTGAGGAGGAGGAGGAA	TTCCTGCTAGAGGAGGAG------	FLLEEEEE	FLLEEE--
CCCCATGATTGCAGCAGCAGT	CCCTGTGATCACAGCGGC---	PHDCSSS	PCDHSG-
CCAATGATGTCCAGTTCATCT	CCAATGGTGTCCAGTTCA---	PMMSSSS	PMVSSS-
GCAGCTCCAGCTCCTGCGGCTGCACCTGCA	GCAGCTCCGGCCCCTGCG------------	AAPAPAAAPA	AAPAPA----
AGAAGCCAGGAAGAGGAGGAA	AGAAGACAGGAAGAGGAG---	RSQEEEE	RRQEEE-
CTCTGTAGCCTGCTGCTCCTGCTG	CTCTGTAGCCTGATGCTC------	LCSLLLLL	LCSLML--
CAGACAAAAAACCCTACCACTATG	CAGCCAAAAACCTCTACC------	QTKNPTTM	QPKTST--
TTTGGCAGCCACCACCTTCCA	TTTTCCTCTCACTGCTGT---	FGSHHLP	FSSHCC-
GGCACGGTCTCCTCCTCCTCCTCG	GGCATGGTCTCCTCCTCC------	GTVSSSSS	GMVSSS--
CCTGAAGTAGAGGAGGAGGAGGAA	CCTGAAGTAGAGGAGGAG------	PEVEEEEE	PEVEEE--
GAGGAGGAAGATGAGGACATGGAAGACAAA	GAGAATGATGAGGCTGTC------------	EEEDEDMEDK	ENDEAV----
GAGAACGTCCCGCTCGATCTGACCCGA	AAAAATGTCCTATTTTTT---------	ENVPLDLTR	KNVLFF---
TTGGACGACGACTCCTCCGATTCCTCA	CTGGGAGATGCATCTTCC---------	MDDDSSDSS	LGDASS---
GAAGACATAGAAGAAGAAGAG	GAAGACATAGAGGAAGAA---	EDIEEEE	EDIEEE-
AAGGAAAGTGAGGAGGAAGAGGAG	AAGGAAAGTGAGGAGGAA------	KESEEEEE	KESEEE--
CCGGGTTCTCCTCCCAACTCTTCA	CCAGTTTCCCATTCAATC------	PGSPPNSS	PVSHSI--
GCCAGCAAGGATGGTGATGAC	CCCAGCAAGGCTGCTGAT---	ASKDGDD	PSKAAD-
GTTCCACAGGCCTCTGTGCCTGGTCTC	GCCCCACAGCCCCCTGTG---------	VPQASVPGL	APQPPV---
GGGGCTGCAGTAGGGGGCAGCGGCGGTGGT	GGGGCTGCAGGAGGGGGC------------	GAAVGGSGGG	GAAGGG----
CAACTTCTTCAGCAGCAGCAGCAA	CAACTTCTTCAGCAGCAG------	QLLQQQQQ	QLLQQQ--
GGGGGAGCCGGCGTGGCAGTG	GTGGGCACCGTGCTGGCA---	GGAGVAV	VGTVLA-
AAGAAGAAGAAAGACAAGGACAAA	AAGAAGAAGAAAGACAAG------	KKKKDKDK	KKKKDK--
CAATCACCAAGAGGTGCGTCA	CAGTTACCAGGAGGTGTG---	QSPRGAS	QLPGGV-
CAGCAGCAGCAGCAGCCACCACCC	CAGCAACAGCCGCCGCCA------	QQQQQPPP	QQQPPP--
ACTGTGAAGGGCATGGCCTTCAGT	GTAGTCAGATTTCATTCC------	TVKGMAFS	VVRFHS--
AACTTGTGCCCGCCGCCGCCA	AGCTTGTGCCCACCGCCG---	NLCPPPP	SLCPPP-
GCTCTACTTCCACCGCCACCACCT	GCTCTGCTTCCACCTCCA------	ALLPPPPP	ALLPPP--
CTAGCACACCAGCAGCAGCAA	CTAGCTCACCAGCAGCAG---	LAHQQQQ	LAHQQQ-
ACACCTAGAAGGTATTTCTTCATGGTT	AGTCTAAGACTGGCAATC---------	TPRRYFFMV	SLRLAI---
CTCATTTTGTCAGGAATTGGATTGACACTA	CTCATTTTTGTCAGGAAT------------	LILSGIGLTL	LIFVRN----
CAAACAGCACCACCTACTCCACCAACC	CAAGCGGCGCCACCCACT---------	QTAPPTPPT	QAAPPT---
ATGGAGGATGAGGAAGAAGAG	ATGGAGGACGAGGAAGCA---	MEDEEEE	MEDEEA-
GTGGATTCGGAAGAGGAGGAGGAAGAA	GTGGATTCGGAAGAGGAG---------	VDSEEEEEE	VDSEEE---
CCATCGCAAGGAACTTCAGCC	CCATCTCAAGAAGCCCCA---	PSQGTSA	PSQEAP-
TTTACATGTAGCTGTGATGAG	GTGCTTTGCTGCTCCAGT---	FTCSCDE	VLCCSS-
ATGAAGAGCGGCGGAGGCGGA	ATGAAGAGCGGCGGAGGC---	MKSGGGG	MKSGGG-
CTGGGGGCCAGTGGTGGCGGA	CCCGGGGCCGGTGGTGGC---	MGASGGG	PGAGGG-
GAGGCTGCCGGTGGCTCATCT	GAGGCTGCCAGCAGCTCA---	EAAGGSS	EAASSS-
CTACCGCTTCCAAGGTTCCTG	CTACCCTTCCAAGGTTCC---	LPLPRFL	LPFQGS-
CCCGGTTTTCCAGGTCCCCCGGGACCT	CCTGGTTTTCCTGGTCCC---------	PGFPGPPGP	PGFPGP---
AGCGCGGCGGAGGAGGAGGAA	AGCCTGGCGGAAGAGGAG---	SAAEEEE	SLAEEE-
CACTTCATTGTGGGCAGGCTC	CACCTCATTGGGGCAGGG---	HFIVGRL	HLIGAG-
GCATCACCAACGCCTCCGCCA	GCATCACCACCGCCTCCG---	ASPTPPP	ASPPPP-
CTGCGCCAAGCTGCTGCTGCG	CTGCGCCAGGCTGCTTCT---	MRQAAAA	LRQAAS-
AACAGTACCAATGGCAGCAATGGCAGT	AACAGTACCAATGGCAGC---------	NSTNGSNGS	NSTNGS---
CCTGTTCTAGAAGAGGAGGAA	CCTGCTCTAGAAGAGGAG---	PVLEEEE	PALEEE-
GCTGGGACCCCAGTTCCTGAGCCTGTTCCG	GCTGGGACCCCAGTTCCT------------	AGTPVPEPVP	AGTPVP----
GCCAGGGCGGTACATAGTGAG	CCCAAGAAGACACCACCT---	ARAVHSE	PKKTPP-
CCCGCCAACGGAGGCGGCGGT	CCCGCCAACGGAGGCGGC---	PANGGGG	PANGGG-
ATTGGAACAGGGACAGGGGCAGGGACAGGA	ATTGGAACAGGGACAGGG------------	IGTGTGAGTG	IGTGTG----
TCACCTCCAGCAGCAGCAGCG	TCACCTCCAGCAGAAGCA---	SPPAAAA	SPPAEA-
AGCCTCAGTGAGGAGGAGGAA	AGCCTCAGTGAGGAGGAG---	SLSEEEE	SLSEEE-
GAGGACCAGGAGGAAGAGGAA	GAGGACCAGGAGGAAGAG---	EDQEEEE	EDQEEE-
TTCGACCTCGATCCTGATCCTGAC	TTCGACCTGGATCCTGAT------	FDLDPDPD	FDLDPD--
CCTCCTCCCCCTCCCCCCTTGCCACCCCCT	CCACCCCCACCTGCCCCC------------	PPPPPPLPPP	PPPPAP----
AAAGGCAAATGCCAGGCCCCGTGCCAGTCA	AACGTTAAATGCCAGACC------------	KGKCQAPCQS	NVKCQT----
AGTCTTTTGGAGGAGGAAGTGGAGGAGGAG	AGTCTTTTGGAGGAGGAA------------	SLLEEEVEEE	SLLEEE----
CCAGGAATGGCTCAGGCTCAGGCC	CCAGGAATGGCTCCGGCT------	PGMAQAQA	PGMAPA--
TTCCTCTCCCTTCTCCTCCTCCTT	CTCCTGTCCCTGCTCCTC------	FLSLLLLL	LLSLLL--
GTCAAGGAGTTGCTGCTGCTC	TGGCAGCAGTCGCGGCCG---	VKELLLL	WQQSRP-
GGCGGTGGTGGCGCTGGCGGCCGTGGT	GCGGCGGGGGGCGCTGGC---------	GGGGAGGRG	AAGGAG---
AACCGAGAGCCTCCTCCTCCG	AGCCAAGACCCTCCTCCT---	NREPPPP	SQDPPP-
ACCCTGTATGATGATGATGATGATGAC	ACCCTGTATGATGATGAT---------	TLYDDDDDD	TLYDDD---
GATGAAGAAGACGAGGAGGAT	GATGAAGAGGAAGAGGAG---	DEEDEED	DEEEEE-
GCGCCCCAGGGCGGCGGCGGG	GCGCCCCAGGGCAGCAGC---	APQGGGG	APQGSS-
GAAGAGTATGAGGAGGAGGAA	GAGGAGTATGATGAAGAG---	EEYEEEE	EEYDEE-
AAAGCGGTGGCTGCGGCAGCGGCG	AAAGCCGTGGCTGCGGCA------	KAVAAAAA	KAVAAA--
CCCGGGGACGCAGCAGCCGCT	CCCGGGGACGCTGCAGCC---	PGDAAAA	PGDAAA-
GATACACCTGCATCCAGCAGT	GACACACCTGGATTCAGC---	DTPASSS	DTPGFS-
ACACCTGCATCCAGCAGCAGT	ACACCTGCATCCAGCAGC---	TPASSSS	TPASSS-
ACACCTGCATCCAGCAGCAGT	ACACCTGCATCCAGCAGC---	TPASSSS	TPASSS-
