wid.1	wid.2	amino_acid.1	amino_acid.2
CTGCCGCTCCTGAGGCCT	CTGGCA------ACCCGG	MPLLRP	LA--TR
AGGGGACCTGGGGGT	AGGGGG---TCTGGG	RGPGG	RG-SG
ACTTCAACACCCACTCCAACTCCA	ACTTCA------------ATACCC	TSTPTPTP	TS----IP
CCTTATTCTTCCTCTTCTTCCTCT	CCTTAT------------TCTTCC	PYSSSSSS	PY----SS
TGCTCCAATATCACTCAG	TGCTCC------AGCTCC	CSNITQ	CS--SS
ATGTTTGGTGGGAAA	ATGTTA---GGCCGG	MFGGK	ML-GR
TGTGGACTTGAAGAC	TGTGAA---CATGGA	CGLED	CE-HG
GGAGAAGAAGCCGAAGCA	GGAGAA------GAAGCC	GEEAEA	GE--EA
GACGACGAGGAGGAA	GACGAC---GAGGAG	DDEEE	DD-EE
TCCCCTAGTAGTAGC	TCCCCT---AGTAGT	SPSSS	SP-SS
GTTGGCGTGCTTTTC	CATGGT---TGGCGT	VGVLF	HG-WR
ATGAATGAAAAGGATGAGAAA	ATGAAT---------GAAAAG	MNEKDEK	MN---EK
GGAAGTTTTTCCTCA	GGAAGG---GATTTC	GSFSS	GR-DF
ACCAGGGCTGCTGCC	ACCAGG---ACTGCT	TRAAA	TR-TA
GAGTCCGGCGAGAAA	AGGAGT---CGACTG	ESGEK	RS-RL
ACAGAAGGCCCGGCA	GGGGAA---GTCCTG	TEGPA	GE-VL
CCCGGAGAGGACAGCCGGGAT	CCTGGA---------AAGGAC	PGEDSRD	PG---KD
GTGGAGGGTGAAGGAATTGTTACT	GAGAAG------------GCTGGA	VEGEGIVT	EK----AG
GAGAAGGAAGAAGAG	GAGAAG---GAGGAA	EKEEE	EK-EE
GGCTGCGGCGGCGGT	GGCTGC---GGCAGC	GCGGG	GC-GS
GCCCTCGACGATGCA	GCCCTT---GACGTT	ALDDA	AL-DV
TATGCTACTACGCAA	TATGCT---GTTAGG	YATTQ	YA-VR
GCGGCCGTGGAGGTTTCT	GCGGCG------GTGGTG	AAVEVS	AA--VV
TCAGAGCTGTCAGGGGAACAGCTG	TCGGAC------------CAGTCA	SELSGEQL	SD----QS
GCCCAGTCCTCTTCCTCC	GCCCAG------ACCTCT	AQSSSS	AQ--TS
ATAAGTTTAGGGGAC	AAAAGT---AAAAGG	ISLGD	KS-KR
AGAGCAACTACTACC	AGAGCA---ACTCCT	RATTT	RA-TP
CGTTCCTCCAGAAGCCGC	CGTTCC------TCCAGA	RSSRSR	RS--SR
AGGGAAGATTGTATG	AGGGAA---GCTGGT	REDCM	RE-AG
TCTGCCACCACCACCACTACT	TCTGCC---------ACCACC	SATTTTT	SA---TT
CCCCCAAGCAGCAGT	CCCCCG---AGCAGC	PPSSS	PP-SS
CCCACTCCTCCACCGCCT	CCTACT------CCTCCA	PTPPPP	PT--PP
GTAGAGCGGTCACTCACC	GCAGAG------CAGTCA	VERSLT	AE--QS
CCGCTCCGCAAGAGGCCCCGCCGA	ATTTTT------------GTGTTG	PLRKRPRR	IF----VL
AAGACTTTCCATTTCCAC	AAGTCT------TTCCAT	KTFHFH	KS--FH
GCGTTGCCGCCGCCA	GCGTTG---CCACCG	ALPPP	AL-PP
GCCCCCACCACAACT	ACCCCC---ACCACA	APTTT	TP-TT
CCTGCCACAGCCGCTACCCCAACT	CCTGCC------------CCAGCC	PATAATPT	PA----PA
CACCTTGATGATGAC	CACCTT---GATGAT	HLDDD	HL-DD
CAGCCGGCGGCGGCA	CAGCCA---GCGGCG	QPAAA	QP-AA
TCCTTGGGCTTCCTGCCTCGCAAG	ACAATC------------AGGGGC	SLGFLPRK	TI----RG
AAATTTCCAATCGAGACGCCA	TATTTT---------TCCTAC	KFPIETP	YF---SY
AGCTTCGGGGAGGAA	AGCTTC---AGGGAG	SFGEE	SF-RE
CAACGAGACGAGTCA	CAACAG---GCTGGG	QRDES	QQ-AG
GCAGGAGAGGAAGAG	GCAGGA---GAGGAA	AGEEE	AG-EE
CATGGCTCCAGCTCTTCT	CATGGC------TCCAGC	HGSSSS	HG--SS
GAGGCAATAGGGTCGGGA	GAGGCA------ACAGGG	EAIGSG	EA--TG
CAGGCTGTGATGAGT	CAGGCT---GATGAG	QAVMS	QA-DE
GAATCCGACACGGCA	GAATCC---ATCCTG	ESDTA	ES-IL
AAATCTAAGAAGAAA	AAACCT---AAGAAG	KSKKK	KP-KK
ACTACCCCAGGGACTGTGCCAGCA	ACACAC------------CTCCAG	TTPGTVPA	TH----LQ
CAGCTGCAGCAGCAGCAGCAA	CAGTTG---------CAGCAG	QLQQQQQ	QL---QQ
CCCGTGTTCCCTTGC	CCCGTT---TCCCTT	PVFPC	PV-SL
GGATTGCCAACTCAA	GGATTG---ACAGCT	GLPTQ	GL-TA
AAACCTCTTGAGTGCGGC	GGGACT------CTGGTG	KPLECG	GT--LV
TTAGCCCCCCCACCG	GTAGCT---CCCCCA	LAPPP	VA-PP
ACTCCAAAGAAGAAA	ATTCCA---AAGAAG	TPKKK	IP-KK
CCTCCCGAGGAAGAGGAG	CCTCCC------GAGGAA	PPEEEE	PP--EE
ACCGGGACCCAGGAGGCGACCCAA	ACCGGG------------ACCCAG	TGTQEATQ	TG----TQ
TCTTCCCTGCCTCCA	TCTTCC---CAGCCT	SSLPP	SS-QP
CAGCAGCCGCCGCCA	CCGCAG---CCACCG	QQPPP	PQ-PP
CACACACCGCCGCCC	CACTCA---CCACCG	HTPPP	HS-PP
TGCTGGAACCTGTCTCTA	TGCTGG------AGCCTG	CWNLSL	CW--SL
GGTAGTGGCGGTGGC	GGTAGT---GGCGGT	GSGGG	GS-GG
GAACAGGAGGAGGAGGAGGAA	GAACAG---------GAGGAG	EQEEEEE	EQ---EE
GAGGAGGAAGAGGAAAATGAGGAA	GAGGAA------------GAAGAG	EEEEENEE	EE----EE
GCAGAGGAGGAAGATGAAGAG	GCAGAG---------GAGGAA	AEEEDEE	AE---EE
CAGCGGTTCAATAGC	CCGAGG---GCGGTT	QRFNS	PR-AV
GAGCAAGACGACGAT	GAGCAA---GATGAC	EQDDD	EQ-DD
CCAGGGCTACTTCTA	CCAGGG---CTCCTT	PGLLL	PG-LL
AAAGATGGGCCGGGAAAGGCT	AAAGAT---------GAGCTG	KDGPGKA	KD---EL
ATTTCAGGCCCAGGCCCG	ATTTCA------GGCCCA	ISGPGP	IS--GP
GGTGCCGAAAGCAGA	AATGTG---GCTAAC	GAESR	NV-AN
CCTGATGAAGAAGAG	CCTGAT---GAAGAA	PDEEE	PD-EE
AAACAAGAAGAAGAG	AAACAA---GAAAAA	KQEEE	KQ-EK
CGAGCTGGAGGCGGG	CGAGCT---GGAGGC	RAGGG	RA-GG
AAGCTGAGCACAAGC	AAGCTG---ACCACA	KLSTS	KL-TT
CACGAGAGCAGCAGT	CGCGAG---TGCAGC	HESSS	RE-CS
GCCAATATGATATCC	GCCAGT---ATTAGA	ANMIS	AS-IR
GATTGGAGCAACTCT	GATTGG---AACAAC	DWSNS	DW-NN
ACACATAGAGATAGAGAC	ACACAC------AGAGAT	THRDRD	TH--RD
CTGAGCGCAGCGGCC	CTGAGC---GCAGCG	MSAAA	LS-AA
GAGACAGAGGAAGAG	GAGACA---GAGGAA	ETEEE	ET-EE
TACGACATCGCTAAC	TATGAC---AACACT	YDIAN	YD-NT
GGCGGCGGCGGCGCGGGCGGA	GGCGGC---------GCGGGC	GGGGAGG	GG---AG
CCAAACACGCCAACCACG	CCAAAC------GCATCA	PNTPTT	PN--AS
GAAAAAGAACGGGAGCGA	GAAAAA------GAACGG	EKERER	EK--ER
AGCGGTGCCAGCGCCAGT	AGCGGT------GCTAGC	SGASAS	SG--AS
AGCAAAGAGGAAGAG	AGCAAA---GAGGAA	SKEEE	SK-EE
GAGAAGGAAGAGGAA	GAGAAG---GAAGAG	EKEEE	EK-EE
GGTGACGGCGGCGGG	GGCGAT---GGCGGC	GDGGG	GD-GG
GTGGGGGATGACGAT	GTGGGG---GATGAC	VGDDD	VG-DD
GGCACCGCCGCCGCA	GGCACC---GCCGCC	GTAAA	GT-AA
GAAGGGGAGGAGGAA	GAAGGG---GAGGAG	EGEEE	EG-EE
GAGGGAGAGGAAGAG	GAGGGA---GAGGAA	EGEEE	EG-EE
CCGGCTCCACCTCCACCC	CCGGCC------CCACCT	PAPPPP	PA--PP
CTTCCTGCTGGTGAAGTGGCCGGC	CTTCCT------------GCTGGT	LPAGEVAG	LP----AG
AAGTCACTACCACTGCAG	GAGTCC------CTGGCA	KSLPLQ	ES--LA
TACTACGCCGCGGCA	ACCTAC---GCCGCG	YYAAA	TY-AA
GCAGGGGCGGCGGCGGCA	GCGGGG------GCAGCG	AGAAAA	AG--AA
GACTACGGAGGTGGA	GAGTAC---GGCGGT	DYGGG	EY-GG
GAAGACAACAAGGAGAACAAA	GAAGAC---------AACAAG	EDNKENK	ED---NK
TCCCAGTCAGGGTCAGGA	TCACAG------TCAGGG	SQSGSG	SQ--SG
GAAGAAAAGAACAAGAAT	GAAAAA------AAGAAC	EEKNKN	EK--KN
GAAGGACCAGCAAAG	GAAGGA---CTCTCA	EGPAK	EG-LS
GCATCCACCACCACT	GCATCT---ACCACC	ASTTT	AS-TT
CACCCGGAAGAGGAA	CACCCG---GAAGAG	HPEEE	HP-EE
GATGATGAAGAAGAG	GATGAT---GAAGAA	DDEEE	DD-EE
GCGGAAGAGGACGAGGAT	GCCGAG------GAGGAC	AEEDED	AE--ED
GTTATTCCACCTCCC	GTTATT---CCACCT	VIPPP	VI-PP
GATGAAGAGGATGAGGAC	GATGAG------GAGGAT	DEEDED	DE--ED
AAGAAAAATAAAGGG	AAGGAA---CAGACA	KKNKG	KE-QT
CGCTTCTGGGGACTG	AGATTC---AAAGAA	RFWGL	RF-KE
TCCACCCCGCCCCCGCCCCCGCCG	TCCACC------------CCTCCC	STPPPPPP	ST----PP
CCCGGCGTGCCGTCC	CGTGAC---CGTCTG	PGVPS	RD-RL
GGAAACAGCCCTCCAGCCAGTGAG	GGAAAC------------AGCTCT	GNSPPASE	GN----SS
GGATCCGGGGGAGGC	GGATCT---GGGGGA	GSGGG	GS-GG
CTGCTGGCTGCTGCC	CTTCTG---GCTGCT	MLAAA	LL-AA
CCATATGCTCAGGCTCAA	CCATAT------GCCCAG	PYAQAQ	PY--AQ
TTTTCAGAAGTAGCACGC	TTCGGA------ATAGCA	FSEVAR	FG--IA
AAAAAAGAAGAAGAAGAGGAGGAG	ATAAAA------------GAAGAA	KKEEEEEE	IK----EE
AAGCACCAAGGCTCTAGGAAG	AAGCAC---------AAACGC	KHQGSRK	KH---KR
CACTTCTTGTTGTTA	CACTTC---TTGTTG	HFLLL	HF-LL
GGGCTCGGTTCACAG	GGTCTC---AGTTCA	GLGSQ	GL-SS
CGGGGAATCCGAAGTCGG	GGGGGA------AGCCGA	RGIRSR	GG--SR
GCGACCGCGGCGGCC	GCGACC---GCGGCG	ATAAA	AT-AA
AGCGCGCAGCAGCAA	AGCGCG---CAGCAG	SAQQQ	SA-QQ
AAGGTGAGGACTGTG	AAGATC---GTGGCT	KVRTV	KI-VA
CCAGAGGCAGCGGCA	TCAGAG---GCAGCG	PEAAA	SE-AA
AAACATTGTGACCAA	AAGTAC---GGAGTC	KHCDQ	KY-GV
TTTGGGACAAAATAC	TTTGGG---AGGCAA	FGTKY	FG-RQ
AGTGACAAAAAAACT	CCTGTC---AGAGAA	SDKKT	PV-RE
GAAACTCCTGCAGCC	GAAACG---TCTGCA	ETPAA	ET-SA
TCGGACGCCGGCCAGCGCGCCGCT	TCGGAC------------GGCGGC	SDAGQRAA	SD----GG
GAAGACGAGGACGAT	GAAGAC---GAGGAC	EDEDD	ED-ED
TCAGGTGCTGGAAGT	TCAGGT---GGTGGA	SGAGS	SG-GG
CCAGGCAGCAGCAGT	CCAGGC---AGCAGC	PGSSS	PG-SS
CGCAGCGGTCTGCTA	CGCAGC---CGCCTG	RSGLL	RS-RL
CAGCGGCAGCAGCAA	CAGCGG---CAGCAG	QRQQQ	QR-QQ
GGGAAACAACTGCAGACT	GGGTCG------GCCCGG	GKQLQT	GS--AR
TACCAGGAAGAGGAA	TACCAG---GAAGAG	YQEEE	YQ-EE
CAAGGAACCCCCGGGGCT	CAAGGA------GCCCTC	QGTPGA	QG--AL
CCATGCCCACCACCACCACCT	CCATGC---------CCACCA	PCPPPPP	PC---PP
CACAGTGACCATGATGACCAC	CACAGT---------GACCAT	HSDHDDH	HS---DH
ATTTACCCCCTGTTGCTGCTA	GTCTAC---------CTCCTG	IYPLLLL	VY---LL
GAGAATCGTGAGTGGGTTCGTGCT	GAGAAT------------CTCCTG	ENREWVRA	EN----LL
GGCTCCGCCGCTGCCGCC	GGCTCC------GCCGCT	GSAAAA	GS--AA
CTCAAGGATGCTCGTTCG	TTACAA------AAGGTT	LKDARS	LQ--KV
GGACAGGCTGATGCTGACGCTGAC	GAGCAG------------GCTGAT	GQADADAD	EQ----AD
TTTGACTATGGAGAGGAGCATTCG	TTGGAT------------CACGGA	FDYGEEHS	LD----HG
GCCGAGGAACCAGCCCTG	GGAGAA------GCAACA	AEEPAL	GE--AT
GAGGTCTGGAAGGCAGAGGACACT	AAGGTC------------ACCGAG	EVWKAEDT	KV----TE
AGACAGAGTGTGGATTCT	GAAAAA------CAAGAG	RQSVDS	EK--QE
TTTGCCCACCACCAT	TTTGCC---CACCAC	FAHHH	FA-HH
TCAAGAGAGGAAGAG	TCAAGA---GAGGAA	SREEE	SR-EE
GCCATCACTTCAAAAGACAATAAC	GCTGTC------------AATTCA	AITSKDNN	AV----NS
CAGGATCCTCCTCCG	CAGGAT---CCTCCT	QDPPP	QD-PP
CTTAGGGACTATGAG	CTCAGG---GCCTCT	LRDYE	LR-AS
GACCCCTCTAGAGCCCCCTCT	GAACCC---------ATTCGA	DPSRAPS	EP---IR
TGGACATGGAGGCCC	TGGGCC---CGCGTG	WTWRP	WA-RV
GCTACTGCTGCTGCC	GCTACT---GCTGCT	ATAAA	AT-AA
CATCACCAGCAACAG	CACCAC---CACCAA	HHQQQ	HH-HQ
AGTTGGGAGGACGAAGAT	ATTTGG------GAGGAC	SWEDED	IW--ED
TCGGACTCCAGCTCG	TCAGAC---TCCAGC	SDSSS	SD-SS
TCCATCTCCTCGTCCTCC	TCCATC------TCCTCG	SISSSS	SI--SS
GAGCCAGCACCTGAAGCCCCA	GAGCCA---------GCTCCT	EPAPEAP	EP---AP
GCCATGGCTGCTGCC	GCCATG---GCTGCT	AMAAA	AM-AA
GAACACGAGGAGGAA	GGGCAC---GAGGAG	EHEEE	GH-EE
ATGATGTCCAGTTCA	ATGGTG---TCCAGT	MMSSS	MV-SS
CAGCAGCAGCCACAGCAG	CAGCAG------CAGACA	QQQPQQ	QQ--QT
CATCGACAGCAGCAGCAA	CATCGA------CAGCAG	HRQQQQ	HR--QQ
CACCCGGAAGAGGAA	CACCCG---GAAGAG	HPEEE	HP-EE
GGCATTGTGGCCAAG	AACCTT---GGAGGC	GIVAK	NL-GG
GAGGAGGCGGCGGCA	GAGGAG---GCTGTG	EEAAA	EE-AV
GGCAGCCACCACCTT	TCCTCT---CACTGC	GSHHL	SS-HC
AACGCTAATCGAGAGAAG	AACACT------GATGTA	NANREK	NT--DV
GGACAAAGCAGGAGCTCC	GGACAA------AGCGGG	GQSRSS	GQ--SG
TTAGTTCCTTCTTCC	TCAGTT---CATTCT	LVPSS	SV-HS
CTGCCAGATGACCAA	CTACTG---GATGCC	MPDDQ	LL-DA
CCTTACCCTCAGCCTCAA	GCTTAC------CCTCAG	PYPQPQ	AY--PQ
CAGACAACTCCAGGACCT	CAGTCA------GCTCCA	QTTPGP	QS--AP
TTGAAGGTGGAGAAA	CTGAAG---GAAGAG	MKVEK	LK-EE
TATGGGGAAGAGTGC	TATGGG---GGAGTG	YGEEC	YG-GV
GGTCCTGGAGTCAGAACT	GGTCCT------AGAGTC	GPGVRT	GP--RV
CCGCCTACAACCACA	CCGCCC---ACAACC	PPTTT	PP-TT
CCGCAGCCACCGCCGCCACCACCA	CCGCAG------------GCACCG	PQPPPPPP	PQ----AP
ATCACCAGGGATAAG	ATCACC---AGCGGT	ITRDK	IT-SG
TATTTGGAGTGGATAGGTCAGGAC	TACTTC------------GCCCGG	YLEWIGQD	YF----AR
TCTGAGCTCCTGCTT	TCTGAG---CTCCTG	SELLL	SE-LL
ATCTCAGAAGAAGAGGAGGAAGAG	GTCTCA------------AAAGAA	ISEEEEEE	VS----KE
TCCAGTGAGGAAGAG	TCCAGT---GAGGAA	SSEEE	SS-EE
CAGCGGGAGAAGGAGAAGGAGAAA	CAGAGG------------GAGAAG	QREKEKEK	QR----EK
CGACGGCATGACCAGCATGAT	CGAAGG---------CATGAC	RRHDQHD	RR---HD
GGGGAAGCGGCCGCT	GGGGAA---GCGGCC	GEAAA	GE-AA
GCACCTGGAGACGAT	GGGCCT---GAAGAC	APGDD	GP-ED
AACAAGCAGCAGCAGCAA	AACAAG------CAGCAG	NKQQQQ	NK--QQ
CAGAACAGAGTTATC	CAGAGC---ACAGAT	QNRVI	QS-TD
GGCTCTGAGGAAGAG	GGCTCT---GAGGAA	GSEEE	GS-EE
AGCTCAGGTGGCGGT	AGCTCC---GGTGGC	SSGGG	SS-GG
GAAGACTTAGAGCTTTGGTCAAAA	AAAGAC------------TCAGAG	EDLELWSK	KD----SE
AACTCCAGGCAGCCA	GACTCC---ATGCTG	NSRQP	DS-ML
GCTGCAGTAGGGGGCAGCGGCGGT	GCTGCA------------GGAGGG	AAVGGSGG	AA----GG
AACACGCTACCCCAT	GCTACC---CCATCC	NTLPH	AT-PS
TCACCAAGAGGTGCG	TTACCA---GGAGGT	SPRGA	LP-GG
NTGGCCGGGNTCTACANTCGN	TGCCGA---------GTCTAC	XAGXYXR	CR---VY
GGGTTCATCAGGGATGGGATCAGC	GCGCTC------------GTTGGG	GFIRDGIS	AL----VG
CTTCGGGGGCCAGAG	CTTCGG---GACAGA	LRGPE	LR-DR
TTGCTGTTGCCTTTGACA	TTGCTG------TTGCTT	MLLPLT	LL--LL
TTGACAGGAGGAGGT	TTGACA---GGAGGA	MTGGG	LT-GG
AAGCCCCCGGGTGCGGGTGCGGGC	AAGCCC------------TCGGGT	KPPGAGAG	KP----SG
CAATGTTTGCTTCAA	CACTGT---TTGAGT	QCLLQ	HC-LS
GCGAGCAGCGGAGGCAGT	GCGAGC------GGCGGA	ASSGGS	AS--GG
GGAGGCCACAAACAACCTAAC	GGAGGC---------CCCAAA	GGHKQPN	GG---PK
ACTTCTGGCAAGAAA	ACTTCT---AGCAAG	TSGKK	TS-SK
TGGATGCTCGCGGTC	TGGATG---CCCTCG	WMLAV	WM-PS
GGGGATGCTGCGAATGCTGCA	GGAGAT---------GCTGCG	GDAANAA	GD---AA
CATCACGGAGAGGAC	CATCAT---GAAGAG	HHGED	HH-EE
GAGGAGAAAAAAAAG	GAGGAG---AGAAAA	EEKKK	EE-RK
AGAAGACATTTCTTT	AGAAGA---TATTTC	RRHFF	RR-YF
CGGGATGAGCCTGAGCCA	CAGGAC------GAGCCT	RDEPEP	QD--EP
GTTCCTGGAGGAGGG	GTTCCT---GGAGGA	VPGGG	VP-GG
GCAGAGTCTTCATCT	GCAGAG---TCTTCA	AESSS	AE-SS
TCGGATATTGAGAACGAA	GAAGAC------GCAGAG	SDIENE	ED--AE
GAGAGTGAAGAAGACGAGGAG	GAGAGT---------GAAGAA	ESEEDEE	ES---EE
GGTGTGAACAGTAGC	GGTGTG---AGCAGT	GVNSS	GV-SS
CTCCATGTGGTGGCA	CTCCGT---GTGGAG	LHVVA	LR-VE
GATTCGGAAGAGGAGGAGGAA	GATTCG---------GAAGAG	DSEEEEE	DS---EE
GGAAACCCCAAAGCC	GGAACC---CGCCAA	GNPKA	GT-RQ
GAAGATGATGGTTATGATGAA	GAAGAT---------GAGTCT	EDDGYDE	ED---ES
GCCTCACGTAATGAACACAGA	GCCTTA---------CATAAT	ASRNEHR	AL---HN
TATGAGTACTTTGACAACGTA	TATGAG---------AACTAT	YEYFDNV	YE---NY
GGAACAGGTGACAAG	GGAACA---GATCGC	GTGDK	GT-DR
AAGAGCGGCGGAGGC	AAGAGC---GGCGGA	KSGGG	KS-GG
GCCTACGGGGGCGGT	GCCTAC---GGGGGC	AYGGG	AY-GG
GAAGACGAGGAAGAG	GAAGAT---GAGGAA	EDEEE	ED-EE
GTGGCTTCCGGCCCCTCA	GTGGCT------CCTGAC	VASGPS	VA--PD
CAGAACTACTCTTCC	CAGAAC---TCCTCT	QNYSS	QN-SS
CCTCATCTCCCCACT	CTTTAT---CACGCC	PHLPT	LY-HA
GAGGAGGCGGCTGCGGCG	GAGGAG------GCGGCT	EEAAAA	EE--AA
GTGGCCCTCCTTCTC	GCGGCC---CTCCTT	VALLL	AA-LL
ACGCAGCCGAGATCAAGG	ACGCAG------CAGCGA	TQPRSR	TQ--QR
GCTGCCGGTGGCTCA	GCTGCC---AGCAGC	AAGGS	AA-SS
CTGAAAGATGCAGCG	CTGAAA---CATTCA	MKDAA	LK-HS
GGTTTTCCAGGTCCCCCGGGA	GGTTTT---------CCTGGT	GFPGPPG	GF---PG
CCTCCCACAACAACCACC	CCTCCC------ACAACA	PPTTTT	PP--TT
GAAGCGCTGCTGCTA	GAAGCT---CTGTTG	EALLL	EA-LL
CTTAGGCAGCAGCAGCAGCAA	CTTAGG---------CAGCAG	LRQQQQQ	LR---QQ
CCGGGCCCGCCGCCT	CCGGGC---CCGCCG	PGPPP	PG-PP
GACCACAGCTCCTCA	GACCAC---AACTCC	DHSSS	DH-NS
ACCGTGCCTCCTCCA	ACCGTG---CCTCCT	TVPPP	TV-PP
CCACAGCCTCCTCCTCCA	CAGCAG------CCTCCT	PQPPPP	QQ--PP
TCACCAACGCCTCCG	TCACCA---CCGCCT	SPTPP	SP-PP
CTCTGCAAGAATTCC	CTCTGC---AATATT	LCKNS	LC-NI
GAAGAAGCAGCAGCC	AATGAA---GCAGCA	EEAAA	NE-AA
GCTACTTCTTCTTCCTCCTCC	GCTACT---------TCTTCT	ATSSSSS	AT---SS
CCATCTCCATTGTGTGAA	GTGTCT------TCATCG	PSPLCE	VS--SS
GTCACTCGCCGCCATCGCCAT	GTCACT---------CGAAGC	VTRRHRH	VT---RS
CAGACTTCATGGGAGGCCTCCCTA	CAGACT------------TCACGG	QTSWEASL	QT----SR
CTCATGAAAAAGAAA	CTCATG---AAAAAG	LMKKK	LM-KK
CTGCCGGAGGAGGAA	CTGCCG---GAGGAG	MPEEE	LP-EE
CAGAGCGAAGAGGAA	AACAGC---GATGAG	QSEEE	NS-DE
GAACTCAAGAAGAAA	CAGCTC---AAGAAG	ELKKK	QL-KK
GAATGGGAGGAAGAG	GAGTGG---GAGGAA	EWEEE	EW-EE
AATGATGGTGAAGAG	AACGAT---GATGAA	NDGEE	ND-DE
GGGCCTACTTTGCACCTC	GCACCT------CGTTTG	GPTLHL	AP--RL
AAAGAGAAGAAAAAG	AAAGAG---AAGAAA	KEKKK	KE-KK
GACCAGGAGGAAGAG	GACCAG---GAGGAA	DQEEE	DQ-EE
CATGTCCTAGGACCCCAG	CATCTT------TCAGTA	HVLGPQ	HL--SV
GTAACAGAGGAAGAG	GTAGCA---GATGAA	VTEEE	VA-DE
AACGCTCCTCCTCCG	AATGCT---CCCCCT	NAPPP	NA-PP
TCCACAATATCTTCC	GCCACA---ACATCT	STISS	AT-TS
GACACCTCTCCACCT	GAGATA---ACCCCA	DTSPP	EI-TP
GACAGGGATGGTGATGGC	GACAGG------GACGGT	DRDGDG	DR--DG
AGCCTGCCTTCATCC	GGCCTG---ACTTCA	SLPSS	GL-TS
GTGCTGTGCAAGAAA	GTGCTG---AGCAAG	VLCKK	VL-SK
GCCCGGGCGGCTGCG	GCCCGG---GCGGCT	ARAAA	AR-AA
ACAGGTGAAAACGACGATGAAAAT	ACAGGC------------GAAGGC	TGENDDEN	TG----EG
ATCTTGGCTGCAGCT	ATCTTG---GCTGCA	ILAAA	IL-AA
GATGTGACTAGCAAT	GATGTG---CCTGGC	DVTSN	DV-PG
AGGCAGTTGCTCTTA	AGGACG---TTCCTC	RQLLL	RT-FL
GGGGACGCAGCAGCC	GGGGAC---GCTGCA	GDAAA	GD-AA
ATCTCCACAGCTGCA	ATCTCT---GCAGCT	ISTAA	IS-AA
CAGGTCCCAGCTGGCCATAGCCAG	CAGGTC------------TCGTCT	QVPAGHSQ	QV----SS
GACACACCTTCATCC	GACACA---TCTGCA	DTPSS	DT-SA
CCTGCATCCAGCAGT	CCTGCA---TCCAGC	PASSS	PA-SS
