wid.1	wid.2	amino_acid.1	amino_acid.2
AGAATGGGAATACAGAAA	GAAAAA------CAGGAC	RMGIQK	EK--QD
GCTCGGTACAGCTCAGCA	TTCCGC------TCAGCA	ARYSSA	FR--SA
ATGGAAGTTGGGGCC	GGAAGT---CGGGCC	MEVGA	GS-RA
AAGCTCCTTTGGCTG	CGCCTA---TGGTTG	KLLWL	RL-WL
CTGATAAAGGAGTCT	ACACTG---GAGTCT	MIKES	TL-ES
CGAAGTAATGCTGCC	AATACT---GCTTCC	RSNAA	NT-AS
GTAAGCATTGGTGAGAAA	ATTGTT------GAAGAA	VSIGEK	IV--EE
TCTGCGGGAACCAGCGAC	GAACCC------ACCAGC	SAGTSD	EP--TS
AGCCAAAGTTTTGTC	CCAAAG---TTTGTT	SQSFV	PK-FV
ACACCCTACCATTTTACT	TACCCT------TTTACT	TPYHFT	YP--FT
AGGTTACAATCCGGT	TCCCTT---TCAGGT	RLQSG	SL-SG
TTCATACCTGAAAGATGTCAGTTG	ACACTT------------TGGTTA	FIPERCQL	TL----WL
GAAAGTACAATTCTC	AGAGAC---GTTCTC	ESTIL	RD-VL
CACAGATTACAATGG	ACAGAT---ACAATG	HRLQW	TD-TM
AGCGCCGCGGCCCCGGCGGCG	GTGCCT---------TCCAGT	SAAAPAA	VP---SS
AAGCTGGACACGGAA	CCGGCC---GCGGAA	KLDTE	PA-AE
TTTGCTGAGCACATC	GACATC---CTCATT	FAEHI	DI-LI
CAGAATATCGAGAAG	AGAACA---CAGAAG	QNIEK	RT-QK
CATTTTGATCAGAATGTT	GTGCTG------GCTGTG	HFDQNV	VL--AV
GCTAGTACGTATGCT	ATTAAA---CATGCC	ASTYA	IK-HA
CGAAGCTATGGCTAC	AGCTCT---GGCTAC	RSYGY	SS-GY
AATGCTCTTTCTGTAACCAGT	TCTGCG---------ACCAGT	NALSVTS	SA---TS
TCCATACCATCAGAT	AAAGTT---TCAGAT	SIPSD	KV-SD
ATCAACACAGAAGTCCCTGATGTC	GACTCT------------GATGTC	INTEVPDV	DS----DV
ACTGACAGTCATACA	GGCAAC---CATACA	TDSHT	GN-HT
AGTGAGGGGGAGCAT	GCGAGG---GAGCAC	SEGEH	AR-EH
TCAAGTACGCACAGT	AACGCA---CACTGT	SSTHS	NA-HC
ACTATTACAGATGTGGAAGCTGTT	GTGATC------------GCTGCT	TITDVEAV	VI----AA
CTTTTACCTGACACA	TTACTT---GACACA	LLPDT	LL-DT
GCGGCACTGACAGGCTTT	CTGCCA------GGCTTT	AALTGF	LP--GF
TCGGAGAAGTTGGAACAGCAAGAT	GATGAG------------GACGAT	SEKLEQQD	DE----DD
AGAGCACACGCTTCGCCAAGGACA	TTGCAG------------AGGACA	RAHASPRT	LQ----RT
ACGCTGTTTGTTCAA	CGCTGT---GTCCAA	TLFVQ	RC-VQ
CCTGAAGTGATTCTA	GAAGAG---ATTCTA	PEVIL	EE-IL
AATCCCGAATATGATTAT	GTCAGT------GATTAT	NPEYDY	VS--DY
TTGATGATTGACCCG	ATTCTT---GACCCG	MMIDP	IL-DP
ACCTCGACTGTCCAT	TTGGCT---GTCCAT	TSTVH	LA-VH
ACCGCGCCCCCGCACCACAGA	CGGGGC---------CATGAC	TAPPHHR	RG---HD
TCCCAGCCGCCTTCA	CAGCAG---CCTTCA	SQPPS	QQ-PS
GGCTCAGTGCCACTG	TCTGCA---CCTTTT	GSVPL	SA-PF
TCTAACCCTGGGATT	ATACAG---AACTTA	SNPGI	IQ-NL
TCCAGTACCACAGAG	AATAAC---ACCGAG	SSTTE	NN-TE
ACTTCAGGAGAGACT	TTGGAA---GAGACT	TSGET	LE-ET
TGCGAGGGTCCCATC	GCGAGG---CCCATC	CEGPI	AR-PI
CCCCTCGGGGTGGGCGGGGCT	GAAGAA---------CCGTCA	PLGVGGA	EE---PS
GGCAGCCCCAACAGG	AGCTCC---AGCAGG	GSPNR	SS-SR
TCGTTAGGTGTTTCCAAG	GACCTT------TCCAAG	SLGVSK	DL--SK
AGCTCTGGCAGGAAC	TCTGAC---AGGAAC	SSGRN	SD-RN
GAAGTATTAAGAGATCCAATT	AGCATT---------GCAATC	EVLRDPI	SI---AI
AACTCCCCGCTCTGCTGCCCTGAA	TCAGAC------------CCTGAA	NSPLCCPE	SD----PE
AGCTCTGGGGACTTG	TCTGAG---GACTTA	SSGDL	SE-DL
GGGTTCTGGACAGGT	TCCCCA---AGCCGT	GFWTG	SP-SR
CCTGGTGAGCAGGAGGAACTGCGG	GGAGCA------------TTGAAG	PGEQEELR	GA----LK
GATCACTGTGTGCTG	CCCTAT---GTGCTA	DHCVL	PY-VL
AGTGGTCTACCAAGC	GAACCA---CCACCC	SGLPS	EP-PP
AGAGCTCGCCCAACGAGA	CGCACA------ATGAGA	RARPTR	RT--MR
AGCTTGGATGCCCGT	TCGATT---GCCCGT	SLDAR	SI-AR
CGTGGCGTGCCTCCG	GTCTCG---CCCCCA	RGVPP	VS-PP
GACATAGGCAAGGTG	ATGGTT---GAAGTA	DIGKV	MV-EV
TCAGCCTTGGAAAGA	GCCTCG---GAGAGA	SALER	AS-ER
GTAATCGACCTTCCA	AACTAC---ATTCCA	VIDLP	NY-IP
CTCCTGGCTCCACTGATC	GCTCTA------CTGATC	LLAPLI	AL--LI
TCGAGCCCCCAGGGA	AGTTCC---CAGGGG	SSPQG	SS-QG
TATGTTTTTAGGACC	GGCTCT---CGGAGC	YVFRT	GS-RS
ACACTGCTGCAGGAGCCT	CTGCTA------GAGTCT	TLLQEP	LL--ES
GCCCCACACCTCTCAGAA	CACCCC------TCAGAA	APHLSE	HP--SE
TCCAAGTTCAGTAATGATGAC	AGCCGT---------GATGAC	SKFSNDD	SR---DD
TCCAGATACCTGTAC	ATGGAG---GTTTTC	SRYLY	ME-VF
TTCAAAATGAACCATAAA	AAGAAG------CAGAAG	FKMNHK	KK--QK
TGCCAGCTGTTGGTC	CTGGAG---TTGGTC	CQLLV	LE-LV
GAGGCCCTGCCAGGTCTG	CCGCTA------GGTCTG	EALPGL	PL--GL
