wid.1	wid.2	amino_acid.1	amino_acid.2
AGAATGGGAATACAGAAA	------GAAAAACAGGAC	RMGIQK	--EKQD
GCTCGGTACAGCTCAGCA	------TTCCGCTCAGCA	ARYSSA	--FRSA
ATGGAAGTTGGGGCC	---GGAAGTCGGGCC	MEVGA	-GSRA
AAGCTCCTTTGGCTG	---CGCCTATGGTTG	KLLWL	-RLWL
CTGATAAAGGAGTCT	---ACACTGGAGTCT	MIKES	-TLES
CGAAGTAATGCTGCC	---AATACTGCTTCC	RSNAA	-NTAS
GTAAGCATTGGTGAGAAA	------ATTGTTGAAGAA	VSIGEK	--IVEE
TCTGCGGGAACCAGCGAC	------GAACCCACCAGC	SAGTSD	--EPTS
AGCCAAAGTTTTGTC	---CCAAAGTTTGTT	SQSFV	-PKFV
ACACCCTACCATTTTACT	------TACCCTTTTACT	TPYHFT	--YPFT
AGGTTACAATCCGGT	---TCCCTTTCAGGT	RLQSG	-SLSG
TTCATACCTGAAAGATGTCAGTTG	------------ACACTTTGGTTA	FIPERCQL	----TLWL
GAAAGTACAATTCTC	---AGAGACGTTCTC	ESTIL	-RDVL
CACAGATTACAATGG	---ACAGATACAATG	HRLQW	-TDTM
AGCGCCGCGGCCCCGGCGGCG	---------GTGCCTTCCAGT	SAAAPAA	---VPSS
AAGCTGGACACGGAA	---CCGGCCGCGGAA	KLDTE	-PAAE
TTTGCTGAGCACATC	---GACATCCTCATT	FAEHI	-DILI
CAGAATATCGAGAAG	---AGAACACAGAAG	QNIEK	-RTQK
CATTTTGATCAGAATGTT	------GTGCTGGCTGTG	HFDQNV	--VLAV
GCTAGTACGTATGCT	---ATTAAACATGCC	ASTYA	-IKHA
CGAAGCTATGGCTAC	---AGCTCTGGCTAC	RSYGY	-SSGY
AATGCTCTTTCTGTAACCAGT	---------TCTGCGACCAGT	NALSVTS	---SATS
TCCATACCATCAGAT	---AAAGTTTCAGAT	SIPSD	-KVSD
ATCAACACAGAAGTCCCTGATGTC	------------GACTCTGATGTC	INTEVPDV	----DSDV
ACTGACAGTCATACA	---GGCAACCATACA	TDSHT	-GNHT
AGTGAGGGGGAGCAT	---GCGAGGGAGCAC	SEGEH	-AREH
TCAAGTACGCACAGT	---AACGCACACTGT	SSTHS	-NAHC
ACTATTACAGATGTGGAAGCTGTT	------------GTGATCGCTGCT	TITDVEAV	----VIAA
CTTTTACCTGACACA	---TTACTTGACACA	LLPDT	-LLDT
GCGGCACTGACAGGCTTT	------CTGCCAGGCTTT	AALTGF	--LPGF
TCGGAGAAGTTGGAACAGCAAGAT	------------GATGAGGACGAT	SEKLEQQD	----DEDD
AGAGCACACGCTTCGCCAAGGACA	------------TTGCAGAGGACA	RAHASPRT	----LQRT
ACGCTGTTTGTTCAA	---CGCTGTGTCCAA	TLFVQ	-RCVQ
CCTGAAGTGATTCTA	---GAAGAGATTCTA	PEVIL	-EEIL
AATCCCGAATATGATTAT	------GTCAGTGATTAT	NPEYDY	--VSDY
TTGATGATTGACCCG	---ATTCTTGACCCG	MMIDP	-ILDP
ACCTCGACTGTCCAT	---TTGGCTGTCCAT	TSTVH	-LAVH
ACCGCGCCCCCGCACCACAGA	---------CGGGGCCATGAC	TAPPHHR	---RGHD
TCCCAGCCGCCTTCA	---CAGCAGCCTTCA	SQPPS	-QQPS
GGCTCAGTGCCACTG	---TCTGCACCTTTT	GSVPL	-SAPF
TCTAACCCTGGGATT	---ATACAGAACTTA	SNPGI	-IQNL
TCCAGTACCACAGAG	---AATAACACCGAG	SSTTE	-NNTE
ACTTCAGGAGAGACT	---TTGGAAGAGACT	TSGET	-LEET
TGCGAGGGTCCCATC	---GCGAGGCCCATC	CEGPI	-ARPI
CCCCTCGGGGTGGGCGGGGCT	---------GAAGAACCGTCA	PLGVGGA	---EEPS
GGCAGCCCCAACAGG	---AGCTCCAGCAGG	GSPNR	-SSSR
TCGTTAGGTGTTTCCAAG	------GACCTTTCCAAG	SLGVSK	--DLSK
AGCTCTGGCAGGAAC	---TCTGACAGGAAC	SSGRN	-SDRN
GAAGTATTAAGAGATCCAATT	---------AGCATTGCAATC	EVLRDPI	---SIAI
AACTCCCCGCTCTGCTGCCCTGAA	------------TCAGACCCTGAA	NSPLCCPE	----SDPE
AGCTCTGGGGACTTG	---TCTGAGGACTTA	SSGDL	-SEDL
GGGTTCTGGACAGGT	---TCCCCAAGCCGT	GFWTG	-SPSR
CCTGGTGAGCAGGAGGAACTGCGG	------------GGAGCATTGAAG	PGEQEELR	----GALK
GATCACTGTGTGCTG	---CCCTATGTGCTA	DHCVL	-PYVL
AGTGGTCTACCAAGC	---GAACCACCACCC	SGLPS	-EPPP
AGAGCTCGCCCAACGAGA	------CGCACAATGAGA	RARPTR	--RTMR
AGCTTGGATGCCCGT	---TCGATTGCCCGT	SLDAR	-SIAR
CGTGGCGTGCCTCCG	---GTCTCGCCCCCA	RGVPP	-VSPP
GACATAGGCAAGGTG	---ATGGTTGAAGTA	DIGKV	-MVEV
TCAGCCTTGGAAAGA	---GCCTCGGAGAGA	SALER	-ASER
GTAATCGACCTTCCA	---AACTACATTCCA	VIDLP	-NYIP
CTCCTGGCTCCACTGATC	------GCTCTACTGATC	LLAPLI	--ALLI
TCGAGCCCCCAGGGA	---AGTTCCCAGGGG	SSPQG	-SSQG
TATGTTTTTAGGACC	---GGCTCTCGGAGC	YVFRT	-GSRS
ACACTGCTGCAGGAGCCT	------CTGCTAGAGTCT	TLLQEP	--LLES
GCCCCACACCTCTCAGAA	------CACCCCTCAGAA	APHLSE	--HPSE
TCCAAGTTCAGTAATGATGAC	---------AGCCGTGATGAC	SKFSNDD	---SRDD
TCCAGATACCTGTAC	---ATGGAGGTTTTC	SRYLY	-MEVF
TTCAAAATGAACCATAAA	------AAGAAGCAGAAG	FKMNHK	--KKQK
TGCCAGCTGTTGGTC	---CTGGAGTTGGTC	CQLLV	-LELV
GAGGCCCTGCCAGGTCTG	------CCGCTAGGTCTG	EALPGL	--PLGL
