wid.1	wid.2	amino_acid.1	amino_acid.2
CTGCCGCTCCTGAGGCCT	CTGGCAACCCGG------	MPLLRP	LATR--
AGGGGACCTGGGGGT	AGGGGGTCTGGG---	RGPGG	RGSG-
ACTTCAACACCCACTCCAACTCCA	ACTTCAATACCC------------	TSTPTPTP	TSIP----
CCTTATTCTTCCTCTTCTTCCTCT	CCTTATTCTTCC------------	PYSSSSSS	PYSS----
TGCTCCAATATCACTCAG	TGCTCCAGCTCC------	CSNITQ	CSSS--
ATGTTTGGTGGGAAA	ATGTTAGGCCGG---	MFGGK	MLGR-
TGTGGACTTGAAGAC	TGTGAACATGGA---	CGLED	CEHG-
GGAGAAGAAGCCGAAGCA	GGAGAAGAAGCC------	GEEAEA	GEEA--
GACGACGAGGAGGAA	GACGACGAGGAG---	DDEEE	DDEE-
TCCCCTAGTAGTAGC	TCCCCTAGTAGT---	SPSSS	SPSS-
GTTGGCGTGCTTTTC	CATGGTTGGCGT---	VGVLF	HGWR-
ATGAATGAAAAGGATGAGAAA	ATGAATGAAAAG---------	MNEKDEK	MNEK---
GGAAGTTTTTCCTCA	GGAAGGGATTTC---	GSFSS	GRDF-
ACCAGGGCTGCTGCC	ACCAGGACTGCT---	TRAAA	TRTA-
GAGTCCGGCGAGAAA	AGGAGTCGACTG---	ESGEK	RSRL-
ACAGAAGGCCCGGCA	GGGGAAGTCCTG---	TEGPA	GEVL-
CCCGGAGAGGACAGCCGGGAT	CCTGGAAAGGAC---------	PGEDSRD	PGKD---
GTGGAGGGTGAAGGAATTGTTACT	GAGAAGGCTGGA------------	VEGEGIVT	EKAG----
GAGAAGGAAGAAGAG	GAGAAGGAGGAA---	EKEEE	EKEE-
GGCTGCGGCGGCGGT	GGCTGCGGCAGC---	GCGGG	GCGS-
GCCCTCGACGATGCA	GCCCTTGACGTT---	ALDDA	ALDV-
TATGCTACTACGCAA	TATGCTGTTAGG---	YATTQ	YAVR-
GCGGCCGTGGAGGTTTCT	GCGGCGGTGGTG------	AAVEVS	AAVV--
TCAGAGCTGTCAGGGGAACAGCTG	TCGGACCAGTCA------------	SELSGEQL	SDQS----
GCCCAGTCCTCTTCCTCC	GCCCAGACCTCT------	AQSSSS	AQTS--
ATAAGTTTAGGGGAC	AAAAGTAAAAGG---	ISLGD	KSKR-
AGAGCAACTACTACC	AGAGCAACTCCT---	RATTT	RATP-
CGTTCCTCCAGAAGCCGC	CGTTCCTCCAGA------	RSSRSR	RSSR--
AGGGAAGATTGTATG	AGGGAAGCTGGT---	REDCM	REAG-
TCTGCCACCACCACCACTACT	TCTGCCACCACC---------	SATTTTT	SATT---
CCCCCAAGCAGCAGT	CCCCCGAGCAGC---	PPSSS	PPSS-
CCCACTCCTCCACCGCCT	CCTACTCCTCCA------	PTPPPP	PTPP--
GTAGAGCGGTCACTCACC	GCAGAGCAGTCA------	VERSLT	AEQS--
CCGCTCCGCAAGAGGCCCCGCCGA	ATTTTTGTGTTG------------	PLRKRPRR	IFVL----
AAGACTTTCCATTTCCAC	AAGTCTTTCCAT------	KTFHFH	KSFH--
GCGTTGCCGCCGCCA	GCGTTGCCACCG---	ALPPP	ALPP-
GCCCCCACCACAACT	ACCCCCACCACA---	APTTT	TPTT-
CCTGCCACAGCCGCTACCCCAACT	CCTGCCCCAGCC------------	PATAATPT	PAPA----
CACCTTGATGATGAC	CACCTTGATGAT---	HLDDD	HLDD-
CAGCCGGCGGCGGCA	CAGCCAGCGGCG---	QPAAA	QPAA-
TCCTTGGGCTTCCTGCCTCGCAAG	ACAATCAGGGGC------------	SLGFLPRK	TIRG----
AAATTTCCAATCGAGACGCCA	TATTTTTCCTAC---------	KFPIETP	YFSY---
AGCTTCGGGGAGGAA	AGCTTCAGGGAG---	SFGEE	SFRE-
CAACGAGACGAGTCA	CAACAGGCTGGG---	QRDES	QQAG-
GCAGGAGAGGAAGAG	GCAGGAGAGGAA---	AGEEE	AGEE-
CATGGCTCCAGCTCTTCT	CATGGCTCCAGC------	HGSSSS	HGSS--
GAGGCAATAGGGTCGGGA	GAGGCAACAGGG------	EAIGSG	EATG--
CAGGCTGTGATGAGT	CAGGCTGATGAG---	QAVMS	QADE-
GAATCCGACACGGCA	GAATCCATCCTG---	ESDTA	ESIL-
AAATCTAAGAAGAAA	AAACCTAAGAAG---	KSKKK	KPKK-
ACTACCCCAGGGACTGTGCCAGCA	ACACACCTCCAG------------	TTPGTVPA	THLQ----
CAGCTGCAGCAGCAGCAGCAA	CAGTTGCAGCAG---------	QLQQQQQ	QLQQ---
CCCGTGTTCCCTTGC	CCCGTTTCCCTT---	PVFPC	PVSL-
GGATTGCCAACTCAA	GGATTGACAGCT---	GLPTQ	GLTA-
AAACCTCTTGAGTGCGGC	GGGACTCTGGTG------	KPLECG	GTLV--
TTAGCCCCCCCACCG	GTAGCTCCCCCA---	LAPPP	VAPP-
ACTCCAAAGAAGAAA	ATTCCAAAGAAG---	TPKKK	IPKK-
CCTCCCGAGGAAGAGGAG	CCTCCCGAGGAA------	PPEEEE	PPEE--
ACCGGGACCCAGGAGGCGACCCAA	ACCGGGACCCAG------------	TGTQEATQ	TGTQ----
TCTTCCCTGCCTCCA	TCTTCCCAGCCT---	SSLPP	SSQP-
CAGCAGCCGCCGCCA	CCGCAGCCACCG---	QQPPP	PQPP-
CACACACCGCCGCCC	CACTCACCACCG---	HTPPP	HSPP-
TGCTGGAACCTGTCTCTA	TGCTGGAGCCTG------	CWNLSL	CWSL--
GGTAGTGGCGGTGGC	GGTAGTGGCGGT---	GSGGG	GSGG-
GAACAGGAGGAGGAGGAGGAA	GAACAGGAGGAG---------	EQEEEEE	EQEE---
GAGGAGGAAGAGGAAAATGAGGAA	GAGGAAGAAGAG------------	EEEEENEE	EEEE----
GCAGAGGAGGAAGATGAAGAG	GCAGAGGAGGAA---------	AEEEDEE	AEEE---
CAGCGGTTCAATAGC	CCGAGGGCGGTT---	QRFNS	PRAV-
GAGCAAGACGACGAT	GAGCAAGATGAC---	EQDDD	EQDD-
CCAGGGCTACTTCTA	CCAGGGCTCCTT---	PGLLL	PGLL-
AAAGATGGGCCGGGAAAGGCT	AAAGATGAGCTG---------	KDGPGKA	KDEL---
ATTTCAGGCCCAGGCCCG	ATTTCAGGCCCA------	ISGPGP	ISGP--
GGTGCCGAAAGCAGA	AATGTGGCTAAC---	GAESR	NVAN-
CCTGATGAAGAAGAG	CCTGATGAAGAA---	PDEEE	PDEE-
AAACAAGAAGAAGAG	AAACAAGAAAAA---	KQEEE	KQEK-
CGAGCTGGAGGCGGG	CGAGCTGGAGGC---	RAGGG	RAGG-
AAGCTGAGCACAAGC	AAGCTGACCACA---	KLSTS	KLTT-
CACGAGAGCAGCAGT	CGCGAGTGCAGC---	HESSS	RECS-
GCCAATATGATATCC	GCCAGTATTAGA---	ANMIS	ASIR-
GATTGGAGCAACTCT	GATTGGAACAAC---	DWSNS	DWNN-
ACACATAGAGATAGAGAC	ACACACAGAGAT------	THRDRD	THRD--
CTGAGCGCAGCGGCC	CTGAGCGCAGCG---	MSAAA	LSAA-
GAGACAGAGGAAGAG	GAGACAGAGGAA---	ETEEE	ETEE-
TACGACATCGCTAAC	TATGACAACACT---	YDIAN	YDNT-
GGCGGCGGCGGCGCGGGCGGA	GGCGGCGCGGGC---------	GGGGAGG	GGAG---
CCAAACACGCCAACCACG	CCAAACGCATCA------	PNTPTT	PNAS--
GAAAAAGAACGGGAGCGA	GAAAAAGAACGG------	EKERER	EKER--
AGCGGTGCCAGCGCCAGT	AGCGGTGCTAGC------	SGASAS	SGAS--
AGCAAAGAGGAAGAG	AGCAAAGAGGAA---	SKEEE	SKEE-
GAGAAGGAAGAGGAA	GAGAAGGAAGAG---	EKEEE	EKEE-
GGTGACGGCGGCGGG	GGCGATGGCGGC---	GDGGG	GDGG-
GTGGGGGATGACGAT	GTGGGGGATGAC---	VGDDD	VGDD-
GGCACCGCCGCCGCA	GGCACCGCCGCC---	GTAAA	GTAA-
GAAGGGGAGGAGGAA	GAAGGGGAGGAG---	EGEEE	EGEE-
GAGGGAGAGGAAGAG	GAGGGAGAGGAA---	EGEEE	EGEE-
CCGGCTCCACCTCCACCC	CCGGCCCCACCT------	PAPPPP	PAPP--
CTTCCTGCTGGTGAAGTGGCCGGC	CTTCCTGCTGGT------------	LPAGEVAG	LPAG----
AAGTCACTACCACTGCAG	GAGTCCCTGGCA------	KSLPLQ	ESLA--
TACTACGCCGCGGCA	ACCTACGCCGCG---	YYAAA	TYAA-
GCAGGGGCGGCGGCGGCA	GCGGGGGCAGCG------	AGAAAA	AGAA--
GACTACGGAGGTGGA	GAGTACGGCGGT---	DYGGG	EYGG-
GAAGACAACAAGGAGAACAAA	GAAGACAACAAG---------	EDNKENK	EDNK---
TCCCAGTCAGGGTCAGGA	TCACAGTCAGGG------	SQSGSG	SQSG--
GAAGAAAAGAACAAGAAT	GAAAAAAAGAAC------	EEKNKN	EKKN--
GAAGGACCAGCAAAG	GAAGGACTCTCA---	EGPAK	EGLS-
GCATCCACCACCACT	GCATCTACCACC---	ASTTT	ASTT-
CACCCGGAAGAGGAA	CACCCGGAAGAG---	HPEEE	HPEE-
GATGATGAAGAAGAG	GATGATGAAGAA---	DDEEE	DDEE-
GCGGAAGAGGACGAGGAT	GCCGAGGAGGAC------	AEEDED	AEED--
GTTATTCCACCTCCC	GTTATTCCACCT---	VIPPP	VIPP-
GATGAAGAGGATGAGGAC	GATGAGGAGGAT------	DEEDED	DEED--
AAGAAAAATAAAGGG	AAGGAACAGACA---	KKNKG	KEQT-
CGCTTCTGGGGACTG	AGATTCAAAGAA---	RFWGL	RFKE-
TCCACCCCGCCCCCGCCCCCGCCG	TCCACCCCTCCC------------	STPPPPPP	STPP----
CCCGGCGTGCCGTCC	CGTGACCGTCTG---	PGVPS	RDRL-
GGAAACAGCCCTCCAGCCAGTGAG	GGAAACAGCTCT------------	GNSPPASE	GNSS----
GGATCCGGGGGAGGC	GGATCTGGGGGA---	GSGGG	GSGG-
CTGCTGGCTGCTGCC	CTTCTGGCTGCT---	MLAAA	LLAA-
CCATATGCTCAGGCTCAA	CCATATGCCCAG------	PYAQAQ	PYAQ--
TTTTCAGAAGTAGCACGC	TTCGGAATAGCA------	FSEVAR	FGIA--
AAAAAAGAAGAAGAAGAGGAGGAG	ATAAAAGAAGAA------------	KKEEEEEE	IKEE----
AAGCACCAAGGCTCTAGGAAG	AAGCACAAACGC---------	KHQGSRK	KHKR---
CACTTCTTGTTGTTA	CACTTCTTGTTG---	HFLLL	HFLL-
GGGCTCGGTTCACAG	GGTCTCAGTTCA---	GLGSQ	GLSS-
CGGGGAATCCGAAGTCGG	GGGGGAAGCCGA------	RGIRSR	GGSR--
GCGACCGCGGCGGCC	GCGACCGCGGCG---	ATAAA	ATAA-
AGCGCGCAGCAGCAA	AGCGCGCAGCAG---	SAQQQ	SAQQ-
AAGGTGAGGACTGTG	AAGATCGTGGCT---	KVRTV	KIVA-
CCAGAGGCAGCGGCA	TCAGAGGCAGCG---	PEAAA	SEAA-
AAACATTGTGACCAA	AAGTACGGAGTC---	KHCDQ	KYGV-
TTTGGGACAAAATAC	TTTGGGAGGCAA---	FGTKY	FGRQ-
AGTGACAAAAAAACT	CCTGTCAGAGAA---	SDKKT	PVRE-
GAAACTCCTGCAGCC	GAAACGTCTGCA---	ETPAA	ETSA-
TCGGACGCCGGCCAGCGCGCCGCT	TCGGACGGCGGC------------	SDAGQRAA	SDGG----
GAAGACGAGGACGAT	GAAGACGAGGAC---	EDEDD	EDED-
TCAGGTGCTGGAAGT	TCAGGTGGTGGA---	SGAGS	SGGG-
CCAGGCAGCAGCAGT	CCAGGCAGCAGC---	PGSSS	PGSS-
CGCAGCGGTCTGCTA	CGCAGCCGCCTG---	RSGLL	RSRL-
CAGCGGCAGCAGCAA	CAGCGGCAGCAG---	QRQQQ	QRQQ-
GGGAAACAACTGCAGACT	GGGTCGGCCCGG------	GKQLQT	GSAR--
TACCAGGAAGAGGAA	TACCAGGAAGAG---	YQEEE	YQEE-
CAAGGAACCCCCGGGGCT	CAAGGAGCCCTC------	QGTPGA	QGAL--
CCATGCCCACCACCACCACCT	CCATGCCCACCA---------	PCPPPPP	PCPP---
CACAGTGACCATGATGACCAC	CACAGTGACCAT---------	HSDHDDH	HSDH---
ATTTACCCCCTGTTGCTGCTA	GTCTACCTCCTG---------	IYPLLLL	VYLL---
GAGAATCGTGAGTGGGTTCGTGCT	GAGAATCTCCTG------------	ENREWVRA	ENLL----
GGCTCCGCCGCTGCCGCC	GGCTCCGCCGCT------	GSAAAA	GSAA--
CTCAAGGATGCTCGTTCG	TTACAAAAGGTT------	LKDARS	LQKV--
GGACAGGCTGATGCTGACGCTGAC	GAGCAGGCTGAT------------	GQADADAD	EQAD----
TTTGACTATGGAGAGGAGCATTCG	TTGGATCACGGA------------	FDYGEEHS	LDHG----
GCCGAGGAACCAGCCCTG	GGAGAAGCAACA------	AEEPAL	GEAT--
GAGGTCTGGAAGGCAGAGGACACT	AAGGTCACCGAG------------	EVWKAEDT	KVTE----
AGACAGAGTGTGGATTCT	GAAAAACAAGAG------	RQSVDS	EKQE--
TTTGCCCACCACCAT	TTTGCCCACCAC---	FAHHH	FAHH-
TCAAGAGAGGAAGAG	TCAAGAGAGGAA---	SREEE	SREE-
GCCATCACTTCAAAAGACAATAAC	GCTGTCAATTCA------------	AITSKDNN	AVNS----
CAGGATCCTCCTCCG	CAGGATCCTCCT---	QDPPP	QDPP-
CTTAGGGACTATGAG	CTCAGGGCCTCT---	LRDYE	LRAS-
GACCCCTCTAGAGCCCCCTCT	GAACCCATTCGA---------	DPSRAPS	EPIR---
TGGACATGGAGGCCC	TGGGCCCGCGTG---	WTWRP	WARV-
GCTACTGCTGCTGCC	GCTACTGCTGCT---	ATAAA	ATAA-
CATCACCAGCAACAG	CACCACCACCAA---	HHQQQ	HHHQ-
AGTTGGGAGGACGAAGAT	ATTTGGGAGGAC------	SWEDED	IWED--
TCGGACTCCAGCTCG	TCAGACTCCAGC---	SDSSS	SDSS-
TCCATCTCCTCGTCCTCC	TCCATCTCCTCG------	SISSSS	SISS--
GAGCCAGCACCTGAAGCCCCA	GAGCCAGCTCCT---------	EPAPEAP	EPAP---
GCCATGGCTGCTGCC	GCCATGGCTGCT---	AMAAA	AMAA-
GAACACGAGGAGGAA	GGGCACGAGGAG---	EHEEE	GHEE-
ATGATGTCCAGTTCA	ATGGTGTCCAGT---	MMSSS	MVSS-
CAGCAGCAGCCACAGCAG	CAGCAGCAGACA------	QQQPQQ	QQQT--
CATCGACAGCAGCAGCAA	CATCGACAGCAG------	HRQQQQ	HRQQ--
CACCCGGAAGAGGAA	CACCCGGAAGAG---	HPEEE	HPEE-
GGCATTGTGGCCAAG	AACCTTGGAGGC---	GIVAK	NLGG-
GAGGAGGCGGCGGCA	GAGGAGGCTGTG---	EEAAA	EEAV-
GGCAGCCACCACCTT	TCCTCTCACTGC---	GSHHL	SSHC-
AACGCTAATCGAGAGAAG	AACACTGATGTA------	NANREK	NTDV--
GGACAAAGCAGGAGCTCC	GGACAAAGCGGG------	GQSRSS	GQSG--
TTAGTTCCTTCTTCC	TCAGTTCATTCT---	LVPSS	SVHS-
CTGCCAGATGACCAA	CTACTGGATGCC---	MPDDQ	LLDA-
CCTTACCCTCAGCCTCAA	GCTTACCCTCAG------	PYPQPQ	AYPQ--
CAGACAACTCCAGGACCT	CAGTCAGCTCCA------	QTTPGP	QSAP--
TTGAAGGTGGAGAAA	CTGAAGGAAGAG---	MKVEK	LKEE-
TATGGGGAAGAGTGC	TATGGGGGAGTG---	YGEEC	YGGV-
GGTCCTGGAGTCAGAACT	GGTCCTAGAGTC------	GPGVRT	GPRV--
CCGCCTACAACCACA	CCGCCCACAACC---	PPTTT	PPTT-
CCGCAGCCACCGCCGCCACCACCA	CCGCAGGCACCG------------	PQPPPPPP	PQAP----
ATCACCAGGGATAAG	ATCACCAGCGGT---	ITRDK	ITSG-
TATTTGGAGTGGATAGGTCAGGAC	TACTTCGCCCGG------------	YLEWIGQD	YFAR----
TCTGAGCTCCTGCTT	TCTGAGCTCCTG---	SELLL	SELL-
ATCTCAGAAGAAGAGGAGGAAGAG	GTCTCAAAAGAA------------	ISEEEEEE	VSKE----
TCCAGTGAGGAAGAG	TCCAGTGAGGAA---	SSEEE	SSEE-
CAGCGGGAGAAGGAGAAGGAGAAA	CAGAGGGAGAAG------------	QREKEKEK	QREK----
CGACGGCATGACCAGCATGAT	CGAAGGCATGAC---------	RRHDQHD	RRHD---
GGGGAAGCGGCCGCT	GGGGAAGCGGCC---	GEAAA	GEAA-
GCACCTGGAGACGAT	GGGCCTGAAGAC---	APGDD	GPED-
AACAAGCAGCAGCAGCAA	AACAAGCAGCAG------	NKQQQQ	NKQQ--
CAGAACAGAGTTATC	CAGAGCACAGAT---	QNRVI	QSTD-
GGCTCTGAGGAAGAG	GGCTCTGAGGAA---	GSEEE	GSEE-
AGCTCAGGTGGCGGT	AGCTCCGGTGGC---	SSGGG	SSGG-
GAAGACTTAGAGCTTTGGTCAAAA	AAAGACTCAGAG------------	EDLELWSK	KDSE----
AACTCCAGGCAGCCA	GACTCCATGCTG---	NSRQP	DSML-
GCTGCAGTAGGGGGCAGCGGCGGT	GCTGCAGGAGGG------------	AAVGGSGG	AAGG----
AACACGCTACCCCAT	GCTACCCCATCC---	NTLPH	ATPS-
TCACCAAGAGGTGCG	TTACCAGGAGGT---	SPRGA	LPGG-
NTGGCCGGGNTCTACANTCGN	TGCCGAGTCTAC---------	XAGXYXR	CRVY---
GGGTTCATCAGGGATGGGATCAGC	GCGCTCGTTGGG------------	GFIRDGIS	ALVG----
CTTCGGGGGCCAGAG	CTTCGGGACAGA---	LRGPE	LRDR-
TTGCTGTTGCCTTTGACA	TTGCTGTTGCTT------	MLLPLT	LLLL--
TTGACAGGAGGAGGT	TTGACAGGAGGA---	MTGGG	LTGG-
AAGCCCCCGGGTGCGGGTGCGGGC	AAGCCCTCGGGT------------	KPPGAGAG	KPSG----
CAATGTTTGCTTCAA	CACTGTTTGAGT---	QCLLQ	HCLS-
GCGAGCAGCGGAGGCAGT	GCGAGCGGCGGA------	ASSGGS	ASGG--
GGAGGCCACAAACAACCTAAC	GGAGGCCCCAAA---------	GGHKQPN	GGPK---
ACTTCTGGCAAGAAA	ACTTCTAGCAAG---	TSGKK	TSSK-
TGGATGCTCGCGGTC	TGGATGCCCTCG---	WMLAV	WMPS-
GGGGATGCTGCGAATGCTGCA	GGAGATGCTGCG---------	GDAANAA	GDAA---
CATCACGGAGAGGAC	CATCATGAAGAG---	HHGED	HHEE-
GAGGAGAAAAAAAAG	GAGGAGAGAAAA---	EEKKK	EERK-
AGAAGACATTTCTTT	AGAAGATATTTC---	RRHFF	RRYF-
CGGGATGAGCCTGAGCCA	CAGGACGAGCCT------	RDEPEP	QDEP--
GTTCCTGGAGGAGGG	GTTCCTGGAGGA---	VPGGG	VPGG-
GCAGAGTCTTCATCT	GCAGAGTCTTCA---	AESSS	AESS-
TCGGATATTGAGAACGAA	GAAGACGCAGAG------	SDIENE	EDAE--
GAGAGTGAAGAAGACGAGGAG	GAGAGTGAAGAA---------	ESEEDEE	ESEE---
GGTGTGAACAGTAGC	GGTGTGAGCAGT---	GVNSS	GVSS-
CTCCATGTGGTGGCA	CTCCGTGTGGAG---	LHVVA	LRVE-
GATTCGGAAGAGGAGGAGGAA	GATTCGGAAGAG---------	DSEEEEE	DSEE---
GGAAACCCCAAAGCC	GGAACCCGCCAA---	GNPKA	GTRQ-
GAAGATGATGGTTATGATGAA	GAAGATGAGTCT---------	EDDGYDE	EDES---
GCCTCACGTAATGAACACAGA	GCCTTACATAAT---------	ASRNEHR	ALHN---
TATGAGTACTTTGACAACGTA	TATGAGAACTAT---------	YEYFDNV	YENY---
GGAACAGGTGACAAG	GGAACAGATCGC---	GTGDK	GTDR-
AAGAGCGGCGGAGGC	AAGAGCGGCGGA---	KSGGG	KSGG-
GCCTACGGGGGCGGT	GCCTACGGGGGC---	AYGGG	AYGG-
GAAGACGAGGAAGAG	GAAGATGAGGAA---	EDEEE	EDEE-
GTGGCTTCCGGCCCCTCA	GTGGCTCCTGAC------	VASGPS	VAPD--
CAGAACTACTCTTCC	CAGAACTCCTCT---	QNYSS	QNSS-
CCTCATCTCCCCACT	CTTTATCACGCC---	PHLPT	LYHA-
GAGGAGGCGGCTGCGGCG	GAGGAGGCGGCT------	EEAAAA	EEAA--
GTGGCCCTCCTTCTC	GCGGCCCTCCTT---	VALLL	AALL-
ACGCAGCCGAGATCAAGG	ACGCAGCAGCGA------	TQPRSR	TQQR--
GCTGCCGGTGGCTCA	GCTGCCAGCAGC---	AAGGS	AASS-
CTGAAAGATGCAGCG	CTGAAACATTCA---	MKDAA	LKHS-
GGTTTTCCAGGTCCCCCGGGA	GGTTTTCCTGGT---------	GFPGPPG	GFPG---
CCTCCCACAACAACCACC	CCTCCCACAACA------	PPTTTT	PPTT--
GAAGCGCTGCTGCTA	GAAGCTCTGTTG---	EALLL	EALL-
CTTAGGCAGCAGCAGCAGCAA	CTTAGGCAGCAG---------	LRQQQQQ	LRQQ---
CCGGGCCCGCCGCCT	CCGGGCCCGCCG---	PGPPP	PGPP-
GACCACAGCTCCTCA	GACCACAACTCC---	DHSSS	DHNS-
ACCGTGCCTCCTCCA	ACCGTGCCTCCT---	TVPPP	TVPP-
CCACAGCCTCCTCCTCCA	CAGCAGCCTCCT------	PQPPPP	QQPP--
TCACCAACGCCTCCG	TCACCACCGCCT---	SPTPP	SPPP-
CTCTGCAAGAATTCC	CTCTGCAATATT---	LCKNS	LCNI-
GAAGAAGCAGCAGCC	AATGAAGCAGCA---	EEAAA	NEAA-
GCTACTTCTTCTTCCTCCTCC	GCTACTTCTTCT---------	ATSSSSS	ATSS---
CCATCTCCATTGTGTGAA	GTGTCTTCATCG------	PSPLCE	VSSS--
GTCACTCGCCGCCATCGCCAT	GTCACTCGAAGC---------	VTRRHRH	VTRS---
CAGACTTCATGGGAGGCCTCCCTA	CAGACTTCACGG------------	QTSWEASL	QTSR----
CTCATGAAAAAGAAA	CTCATGAAAAAG---	LMKKK	LMKK-
CTGCCGGAGGAGGAA	CTGCCGGAGGAG---	MPEEE	LPEE-
CAGAGCGAAGAGGAA	AACAGCGATGAG---	QSEEE	NSDE-
GAACTCAAGAAGAAA	CAGCTCAAGAAG---	ELKKK	QLKK-
GAATGGGAGGAAGAG	GAGTGGGAGGAA---	EWEEE	EWEE-
AATGATGGTGAAGAG	AACGATGATGAA---	NDGEE	NDDE-
GGGCCTACTTTGCACCTC	GCACCTCGTTTG------	GPTLHL	APRL--
AAAGAGAAGAAAAAG	AAAGAGAAGAAA---	KEKKK	KEKK-
GACCAGGAGGAAGAG	GACCAGGAGGAA---	DQEEE	DQEE-
CATGTCCTAGGACCCCAG	CATCTTTCAGTA------	HVLGPQ	HLSV--
GTAACAGAGGAAGAG	GTAGCAGATGAA---	VTEEE	VADE-
AACGCTCCTCCTCCG	AATGCTCCCCCT---	NAPPP	NAPP-
TCCACAATATCTTCC	GCCACAACATCT---	STISS	ATTS-
GACACCTCTCCACCT	GAGATAACCCCA---	DTSPP	EITP-
GACAGGGATGGTGATGGC	GACAGGGACGGT------	DRDGDG	DRDG--
AGCCTGCCTTCATCC	GGCCTGACTTCA---	SLPSS	GLTS-
GTGCTGTGCAAGAAA	GTGCTGAGCAAG---	VLCKK	VLSK-
GCCCGGGCGGCTGCG	GCCCGGGCGGCT---	ARAAA	ARAA-
ACAGGTGAAAACGACGATGAAAAT	ACAGGCGAAGGC------------	TGENDDEN	TGEG----
ATCTTGGCTGCAGCT	ATCTTGGCTGCA---	ILAAA	ILAA-
GATGTGACTAGCAAT	GATGTGCCTGGC---	DVTSN	DVPG-
AGGCAGTTGCTCTTA	AGGACGTTCCTC---	RQLLL	RTFL-
GGGGACGCAGCAGCC	GGGGACGCTGCA---	GDAAA	GDAA-
ATCTCCACAGCTGCA	ATCTCTGCAGCT---	ISTAA	ISAA-
CAGGTCCCAGCTGGCCATAGCCAG	CAGGTCTCGTCT------------	QVPAGHSQ	QVSS----
GACACACCTTCATCC	GACACATCTGCA---	DTPSS	DTSA-
CCTGCATCCAGCAGT	CCTGCATCCAGC---	PASSS	PASS-
